совет: советы
лайфхак: лайфхаки
продуктивность: продуктивность
технология: технология
здоровье: здоровье
рубрика: рубрики
время: время
быть: быть
промокоды: промокоды
подкаст: подкасты
сервис: сервисы сервисом
новость: новости
спорт: спорт
подарок: подарок
онлайнкурсов: онлайнкурсов
которые: которые
помочь: помогут поможет
освоить: освоить
прибыльный: прибыльные
профессия: профессии
избрать: избранных
партнёрский: партнёрских партнёрские
выйти: вышел
трейлер: трейлер
боевик: боевика
крис: крисом
эвансом: эвансом
аной: аной
десерт: десерта десерты
можно: можно
даже: даже
подарить: подарить
полностью: полностью
бесплатный: бесплатная
укрытие: укрытие
постапокалиптическом: постапокалиптическом
будущее: будущем
землёй: землёй
необычный: необычных необычным
кухонный: кухонных кухонном кухонная кухонные
аксессуар: аксессуары
восприятие: восприятия
орган: органы
искажать: искажают
реальность: реальность
образование: образование образования
мультфильм: мультфильм
мультсериал: мультсериал
увидеть: увидеть
вы: вы
почему: почему
осьминог: осьминогов
голубой: голубая
кровь: кровь
самых: самых
дорогой: дороже
фильм: фильмы фильмам
история: истории историй
кино: кино
женский: женских женская женский
рубль: рублей
разряжаются: разряжаются
втрое: втрое
быстрее: быстрее
выгорать: выгорать
условие: условиях
неопределённость: неопределённости
второй: второй
курица: курицы курицей
попробовать: попробуйте попробовать
учёный: учёные
ключевой: ключевой
фактор: фактор
помогать: помогают
придерживаться: придерживаться
диета: диеты
тренировка: тренировок
появиться: появится
возможность: возможностям
поиграть: поиграть
гарри: гарри
игра: игры
хороший: лучшее хорошая
идея: идей
вечерний: вечернего вечернее
делать: делать
желудок: желудок желудка
встать: встал
поздравлять: поздравлять
праздник: праздники
разделение: разделение
сша: сша
выбрать: выбрать
сериал: сериалов
свой: свое свой
весь: все
времён: времён
тост: тосты
бывать: бывают
дешёвый: дешёвых дешевле дешёвой
ещё: ещё
случай: случае
сочетаемость: сочетаемость
слово: слов
всерьёз: всерьёз
смешной: смешные
удачный: удачные удачной удачный
дерево: дерева
новый: нового новые
детализированные: детализированные
спутник: спутник
том: том
стиль: стиль стилю стиля
одежда: одежда
порядок: порядке порядок
гореть: горящей
днём: днём
червь: червя
рождение: рождения
тот: том тех того
кто: кого
разочароваться: разочаровались
работа: работы
учёба: учёба
упростить: упростит
управление: управления
компьютер: компьютер компьютеры
отдельный: отдельных
приложение: приложений приложении
умный: умные
час: часов часами часы
встроить: встроили
устройство: устройства
брать: брать
мужской: мужские мужская
кроссовки: кроссовки
информация: информация
проект: проекте
вакансия: вакансии
одноклассник: одноклассники
рассылка: рассылки
пользовательский: пользовательское
соглашение: соглашение
обработка: обработка обработки
персональный: персональных
данных: данных
сообщество: сообщества сообщество
копирование: копирование
мочь: может можешь
получать: получает получают
комиссия: комиссии
товар: товаров товары
представить: представленных
месяц: месяц месяца
год: года
неделя: неделю
недорогой: недорогих
сейчас: сейчас
праздники: праздники
приготовить: приготовьте
идеальный: идеальную идеальной
сгущёнка: сгущёнку
передаваться: передаётся передаются
проявляться: проявляется
ней: ней
классный: классных
модный: модными модных модную
этот: этом эти эту
весна: весны весной весну
будущий: будущего будущих
жизнь: жизнь
какой: каким
ролевый: ролевые
сделать: сделать
страстный: страстным
совсем: совсем
хотеться: хочется
есть: есть
отличный: отличные
магия: магию
добрый: добрых добрый
комедия: комедии комедию
мрачный: мрачным
быстро: быстро
проспали: проспали
миф: миф мифа мифы мифов
уборка: уборке уборки уборкой
мешать: мешают мешает
поддерживать: поддерживаем поддерживать
понастоящему: понастоящему
повышение: повышения
нейросеть: нейросеть
спортивный: спортивный спортивное спортивные
русский: русский русские
иногда: иногда
полезный: полезны
мудак: мудаком
использовать: используем используя
цитрусовый: цитрусовую цитрусовых цитрусового
кожура: кожуру
всё: всё
игрок: игроки
самого: самого
ненавистный: ненавистного
персонаж: персонажа персонажей
вселенная: вселенной
отношение: отношении
способ: способов
повысить: повысить
психический: психическую
выносливость: выносливость
работать: работает
продуктивный: продуктивной продуктивнее
доказать: доказанных
дух: духа
тайный: тайный
мы: мы
доверять: доверять
начинать: начиная
поздравить: поздравить
коллега: коллегам
выглядеть: выглядеть
газовый: газовую
находка: находки
самые: самые
интересный: интересные
живой: живыми живые
плохой: плохих
привычка: привычка
умеренный: умеренных
количество: количество
произойти: произойдёт
стоять: стоять
рубрики: рубрики
браузеры: браузеры
вдохновение: вдохновение
вебсервисы: вебсервисы
выживание: выживание
колонок: колонка колонками
музыка: музыки музыка
ответ: ответы
отдых: отдых
право: право
прессрелизы: прессрелизы
путешествие: путешествия
рабочий: рабочий рабочего
место: месте
своё: своё
сделай: сделай
богатый: богатым
тест: тестом тесты
рецепт: рецепты
мина: мин
красный: красная красный
рыба: рыба
поделиться: поделитесь
ч: ч
креветками: креветками
помидор: помидоров помидоры
черри: черри
пшённый: пшённая
сливочношоколадный: сливочношоколадный
ликёр: ликёр
рыбный: рыбными рыбный
консервами: консервами
сыр: сыром
голень: голени
индейка: индейки
запечь: запечённые запечённая
соус: соусом
лагман: лагман
говядиной: говядиной
картошка: картошкой
бутерброд: бутерброды
закусочный: закусочный
торт: торт
крабовый: крабовыми
греческий: греческий
горошек: горошком
морковью: морковью
борщ: борщ
тушёнка: тушёнкой
избранный: избранное избранная избранных избранной
фаршированный: фаршированные
фетой: фетой
сырный: сырный сырные
стручковый: стручковой
фасоль: фасоль фасолью
перец: перца
эзогелин: эзогелин
турецкий: турецкий турецкая
суп: суп
куриный: куриное
бедро: бёдра
панировка: панировке панировка
яйцо: яйца
мясо: мясо
желудками: желудками
фалафель: фалафель
холодный: холодной
макароны: макароны
бульон: бульоны
супы: супы
выпечка: выпечки
салат: салаты
маринады: маринады
фастфуд: фастфуд
ингредиент: ингредиенты
исключить: исключить исключено
приготовление: приготовления
подобрать: подобрать
актуальный: актуальные
купоны: купоны
акция: акции
промокод: промокод
включить: включено
расширение: расширение
блокировка: блокировки блокировка
ограничить: ограничен ограниченный
ваш: вашего
удобство: удобства
больше: больше
сайт: сайты
моб: моб
компьютерный: компьютерные
развлечение: развлечения
зоотовары: зоотовары
услуга: услуги
подарки: подарки
цветок: цветы
техник: техника
категория: категории
сезонный: сезонные
сбермаркет: сбермаркет
популярный: популярные
поделитесь: поделитесь
первый: первый
выгода: выгодой
промокоду: промокоду
онлайн: онлайн
действовать: действует
открыть: открыть
красота: красоты
дополнительный: дополнительная
экономия: экономия экономией
разный: разных
техпорт: техпорт
скидка: скидкой скидку
аромат: ароматов
вкусный: вкусный
ролл: ролл
филадельфия: филадельфия
код: коду
важный: важнее важны важная
прослушивание: прослушивание
реклама: рекламы
использование: использовании
промокода: промокода
приём: прием
получи: получи
целый: целый
день: дней
бесплатно: бесплатно
рацион: рационов
бронирование: бронирование
отель: отелей отель
животное: животных
регистрация: регистрации регистрацией регистрацию
мобильный: мобильные мобильных мобильном
спортмастер: спортмастер
магазин: магазины
эльдорадо: эльдорадо
элемент: элемент
яндекспутешествия: яндекспутешествия
взрослый: взрослых
распоряжаться: распоряжается
раздел: разделе
найдёте: найдёте
выгодный: выгодной
предложение: предложения
яндекс: яндекс
многих: многих
других: других
это: этого
нужный: нужны
помощь: помощью
выпадать: выпадающего
понравиться: понравится понравятся
страница: странице
его: его
скопируйте: скопируйте
переходить: переходят
ссылка: ссылки ссылка ссылкам ссылке
просто: просто
воспользоваться: воспользоваться воспользовавшись
акционным: акционным
оформление: оформления
процесс: процесс
поле: поле
вставка: вставки
вставить: вставить
он: он
активироваться: активируется
автоматически: автоматически
специальный: специальному
сумма: суммой
пересчитается: пересчитается
комментарий: комментарии комментариях
активировать: активирует активировать
перейти: перейти перейдите
никакой: никакого никаких никакой
действие: действия
требоваться: требуется
воспользуйтесь: воспользуйтесь
которой: которой
говориться: говорилось
контакт: контакты
конфиденциальность: конфиденциальности
повторный: повторная
промокодов: промокодов
запрещаться: запрещается
размещение: размещение размещением
ресурс: ресурсах
согласие: согласия
рекламный: рекламные
материал: материалы
пройти: прошли
проверка: проверку
специалист: специалистом
опубликовать: опубликованная
данном: данном
являться: является
публичный: публичной
оферта: офертой
определять: определяемой
положение: положениями
гражданский: гражданского
исключительно: исключительно
справочный: справочный
характер: характер
подкасты: подкасты
изображать: изображают
летать: летающих
стильно: стильно
обсуждать: обсуждаем обсуждаемой обсуждать
бы: бы
распознать: распознать
избавиться: избавиться
запускать: запускаем запускать запускают
викторина: викторины
теперь: теперь
стресс: стресс стрессом
восстановиться: восстановиться
простата: простаты
лечить: лечить
февраль: февраля
мой: мой
возвращение: возвращению
домой: домой
вещь: вещей
которых: которых
периодически: периодически
отдыхать: отдыхать
малоизвестный: малоизвестных
факт: фактов факты
откуда: откуда
берётся: берётся
простуда: простуда
губа: губы
ли: ли
алкоголь: алкоголя
экстремальный: экстремальных
ситуация: ситуациях ситуацию
попасть: попасть попадёт попали
каждый: каждый каждым
исторический: исторических
сносить: сносит
крыша: крышу
постоянно: постоянно
занятой: занятым
её: её
исправить: исправить
сменить: сменить
круг: круг
осваивать: осваивать
навык: навыки
удовольствие: удовольствие
финансовый: финансовых
ошибка: ошибок
совершать: совершаемые совершаемых совершайте совершают совершал
любовь: любовь любовью
занять: заняты займёт
выпуск: выпуск
действительно: действительно
ценный: ценные
шататься: шатается
помнить: помнить
изменить: изменить изменив
карьера: карьеру карьере
ребёнок: детей
верить: верить верят
зодиак: зодиака
гадать: гадают
слушай: слушай
гипотеза: гипотезы
пытаться: пытаются пытаясь пытается
объяснить: объяснить
появление: появления
попугай: попугаях
вас: вас
называться: назывались называется называются
древность: древности
взяться: взялись
современный: современных
нездоровый: нездоровой
конкуренция: конкуренции
реагировать: реагируют реагировать
бестактный: бестактные
вопрос: вопросы
родственник: родственников
они: они
мышление: мышления
играть: играть
обыграть: обыграть
часто: часто
здравый: здравый здравым
смысл: смысл
стереотип: стереотипы
голова: голову
собственный: собственную собственный собственные собственном
обманывать: обманывает обманывать
изучить: изучить
более: более
научный: научных научные
выяснить: выяснил выяснить выясним
происходить: происходит
заблуждение: заблуждений заблуждение
даём: даём
избежать: избежать
книга: книгу книгах
литрес: литрес
читайгород: читайгород
светлый: светлые
улучшение: улучшения
настоящий: настоящие
путеводитель: путеводитель
саморазвитие: саморазвитию
собрать: собрали собрать
применять: применяли применяемые применять
успевать: успевать
вредный: вредных
перестать: перестать перестала перестали
откладывать: откладывать откладывай
цель: цель
галерея: галерея
листать: листать
прочитанное: прочитанное
практика: практике
расслабляться: расслабляйтесь
всегда: всегда
найдёт: найдёт
удивить: удивить
рука: руками
издание: изданий
странный: странных
человек: человек человека людей
одной: одной
астрофотограф: астрофотограф
измениться: изменились изменится изменился
миллион: миллионов
близкий: близкого ближайшие близких
выпустить: выпустила выпустить
группа: группу
хоя: хоя
сообщить: сообщить
прекращение: прекращении
россия: россии
раскрыть: раскрыла раскрыт
смартфон: смартфоны
назвать: названный
российский: российском
модель: модель
защищённых: защищённых
функция: функций
коридор: коридор
ужасный: ужасные ужасных ужасным
пример: примеры
техника: техники техника
безопасность: безопасности безопасность
марсоход: марсоход
завёл: завёл
каменный: каменного
готовиться: готовимся готовится
оплата: оплаты
отдавать: отдают
приключение: приключение приключения приключений
пользователь: пользователей
соорудить: соорудил
уличный: уличной уличные
лягушка: лягушки
известный: известных известно
сыграть: сыграть
хеллбоя: хеллбоя
сосуд: сосуды
самом: самом
исследование: исследования исследований
улучшать: улучшает
память: памяти
концентрация: концентрацию
следующий: следующий
насколько: насколько
пост: пост
вызывать: вызывает вызывают вызывать
шейка: шейки
снизить: сниженной
головной: головная
боль: боль
очищается: очищается
нейротоксинов: нейротоксинов
повлиять: повлиять
зачем: зачем
заклеивать: заклеивают
ночь: ночь
опасный: опасно опасную опасных
желтков: желтков
потеть: потеют
ними: ними
иммунный: иммунный
возраст: возрасте
отличаться: отличается
биологический: биологического
организм: организмом
женщина: женщин
род: родов рода
температура: температуру
зппп: зппп
бассейне: бассейне
деменции: деменции
чистка: чистка
печень: печени
слезиться: слезятся
похудеть: похудеть
сдавать: сдавать
общий: общий общего
моча: мочи
расшифровать: расшифровать
результат: результате
заработать: заработать
польза: пользой
имбирь: имбиря
щёки: щёки
бесплодие: бесплодие
противозачаточный: противозачаточные
дать: дам
защита: защиты
хороши: хороши
гиревой: гиревой
выносливый: выносливым
закалить: закалить
гирями: гирями
простой: простых простую простая
эффективный: эффективных эффективного эффективную эффективный эффективной
упражнение: упражнения
похудение: похудения
ходьба: ходьба
ягодицах: ягодицах
накачать: накачать
красивый: красивого
попа: попу попы
хорошо: хорошо
прокачать: прокачать
бёдра: бёдра
чеклист: чеклист
собираться: собирается
погода: погоду погода
колонка: колонка
лёгкий: лёгкие легкие легко
бодрый: бодрого
фигура: фигуру
что: чего
копейка: копейки
гантель: гантелями
стройный: стройных
бёдер: бёдер
круглый: круглой круглую
дропсеты: дропсеты
мышца: мышцы
суперкомплекс: суперкомплекс
гантелями: гантелями
который: который
снимать: снимаем
напряжение: напряжение напряжения
массажный: массажный
январь: января
тренироваться: тренироваться
молодость: молодости
старость: старости старость старостью
здоровый: здоров
зависимость: зависимости зависимостей
физический: физическое
подтянутый: подтянутого
заниматься: занимаются
мальчик: мальчиков мальчика
худеем: худеем
тренажёр: тренажёров
снаряд: снарядов
детский: детские
ребёнка: ребёнка
такой: такие такой
сбросить: сбросить
потерять: потерять
повторение: повторений повторения
тяжёлый: тяжёлая тяжёлого
вес: вес
много: много
минута: минут
убийственный: убийственной
пресс: пресс
скинуть: скинуть
новогодний: новогодних новогодние
каникулы: каникулы
хотеть: хотим
ablтренировки: ablтренировки
подойти: подойдут
спорте: спорте
лайфхакере: лайфхакере
похмелие: похмелья
7минутный: 7минутный
комплекс: комплекс
сесть: сесть
декабрь: декабря
гирей: гирей
следовать: следует
куртка: курток
весну: весну
подарочный: подарочный подарочные подарочных
затосковал: затосковал
выход: выход
девайс: девайс
кухня: кухни
готовка: готовку
разнообразят: разнообразят
триммер: триммер
щётка: щётка
робот: робот робота роботы роботов
мойщик: мойщик
непромокаемый: непромокаемого
кеды: кеды
электронный: электронные электронную электронного
дешевле: дешевле
фигурный: фигурного
дырокол: дырокол
выгодно: выгодно
роботпылесос: роботпылесос
всеинструменты: всеинструменты
отвёртка: отвёртки
инструмент: инструментов инструменты
электрокофемолок: электрокофемолок
пригодиться: пригодиться
настольный: настольные
швабра: швабра
отжим: отжимом
складной: складной
дверной: дверные
упор: упоры
повседневный: повседневным
кроссовок: кроссовок
смартчасы: смартчасы
amoledдисплеем: amoledдисплеем
производство: производство
собирать: собирают собирайте собирать
же: же
человекоподобный: человекоподобные
забавный: забавные
грог: грогу
браузер: браузеры
динамический: динамическим динамических
островок: островком
поддержка: поддержки поддержкой
создатель: создатель
дорси: дорси
соцсеть: соцсеть
удалить: удалить удалив
эксперт: эксперт
считать: считает
контроль: контроля
ии: ии
портативный: портативный
холодильник: холодильник холодильников
охлаждать: охлаждает
продукт: продуктов продукты
лёд: льда лёд
платформа: платформой
музыкальный: музыкальной
научиться: научился
экономить: экономит
парковка: парковки
москва: москва
большой: большой
обновление: обновление
чат‑ботом: чат‑ботом
роскомнадзор: роскомнадзор
космический: космическая
корабль: корабль кораблей
будущем: будущем
устроить: устроен
великий: великие великий
быт: быта
лекарство: лекарств лекарство
интервью: интервью
миколог: микологом
михаил: михаил
вишневский: вишневским
стремительно: стремительно
истощаться: истощаются
нонфикшенкниг: нонфикшенкниг
идёшь: идёшь
кость: кости
историк: историком
палеонтология: палеонтологии
нелиховым: нелиховым
было: было
разогрев: разогрев
хедлайнер: хедлайнера
юрий: юрием
сапрыкин: сапрыкиным
основатель: основателем
ноябрь: ноября
прочитать: прочитала
осень: осенью
октябрь: октября
хлеб: хлеб
степанович: степановичем
нечистота: нечистоты
улица: улицах улицу
отсутствие: отсутствие
мыло: мыла
средневековый: средневековой
псевдоисторический: псевдоисторических
концепция: концепций концепцию
возмущение: возмущение
учёных: учёных
сойлент: сойлент
сверчковый: сверчковые
котлета: котлеты
исследователь: исследователь исследователи
всеволод: всеволодом
остахновичем: остахновичем
когда: когда
изучать: изучать
муравьёв: муравьёв
спрашивать: спрашивают спрашивать
вывести: вывести
их: их
квартира: квартиры
мирмекологом: мирмекологом
павел: павлом
лисицын: лисицыным
сентябрь: сентября
крутой: крутые
интересоваться: интересуется
август: августа
врач: врачей
прошлый: прошлого
человеческий: человеческие
уфология: уфология
думать: думать
июль: июля
сидеть: сидеть
ждать: ждут ждать
фотограф: фотографом
дикий: дикой дикая
природа: природа природы
сергей: сергеем
цветков: цветковым
всётаки: всётаки
она: она её
вертеться: вертится
замечать: замечаем
вращение: вращения
понимать: понимает понимают
современность: современность
александр: александром
сей: сих
сколько: сколько
лететь: лететь
июнь: июня
продолжаться: продолжается
хиромантия: хиромантия
май: мая
после: после
смена: смены
пересчитывать: пересчитываю
палец: пальцы
какойнибудь: какойнибудь
крокодильчик: крокодильчик
экзотологомгерпетологом: экзотологомгерпетологом
татьяна: татьяна
жамойда: жамойда
апрель: апреля апрель
распространённых: распространённых
знаменитый: знаменитый
писателях: писателях
произведение: произведениях
интеллект: интеллект интеллекта
ген: генов
журналист: журналист
казанцев: казанцевой
сложный: сложные сложных сложное сложной сложную
осознанно: осознанно
подсовывать: подсовывают подсовывает
психолог: психологов
светланой: светланой
бронников: бронниковой
казаться: кажется
фантастика: фантастикой
проблема: проблем проблема проблему
глупый: глупые
ничто: ничего
нормально: нормально
объяснять: объясняет объяснять объясняют объясняем
эпидемиолог: эпидемиологом
мать: мать
придумывать: придумывала придумываем
болезнь: болезнь болезней
ольга: ольга
ярмолович: ярмолович
детство: детство детства
больница: больницах
несуществующий: несуществующих
симптом: симптомы
обречён: обречён
власть: власти
серьёзный: серьёзные серьёзная
возвращаться: возвращаются
возобновлять: возобновлять
бывший: бывшим
партнёр: партнёров
этап: этапе
обсуждение: обсуждения обсуждениях
уже: уже
возбуждаться: возбуждаемся
просить: просить
получить: получить
измена: изменах измены
опровергнуть: опровергнуты
наука: наукой
сказать: сказать
оставаться: остаются остаётся остается
приносить: приносят
счастие: счастья
обеспечивать: обеспечивает
ты: ты
экономический: экономическую
нереалистичный: нереалистичным
ожидание: ожидания
разрушить: разрушить
мужчина: мужчине
причина: причины
переживать: переживать переживаю
святой: святого
проходить: проходят
одиночестве: одиночестве
мягкий: мягких мягкими мягкий
родительство: родительство
оно: оно
связь: связи связь
построить: построить построенной
гармоничный: гармоничные
романтический: романтическая
вместе: вместе
пара: пары
которую: которую
спасти: спасти
семейный: семейных семейную семейная
вносить: вносить
ясность: ясность
разговор: разговор
ответить: ответить
обесценивать: обесценивать
спасать: спасать
поддержать: поддержать
депрессия: депрессии
твёрдо: твёрдо
заявить: заявить заявленным заявленной заявленные
окружать: окружающим
личный: личные личного личную личном личным
убеждать: убеждать
социальный: социальной социальных социального социальному социальная
психология: психологии психологию
правильно: правильно
вести: вести
вам: вам
плачутся: плачутся
взаимозависимый: взаимозависимые
мир: мир
открытый: открытые открытыми
перепутать: перепутаны перепутать
роль: роль роли
дружить: дружить
родитель: родителями родителей
читать: читать
индивидуально: индивидуально
выполнить: выполнена выполнено выполнены выполненные
именно: именно
шаблонный: шаблонных
решение: решений решениях
прайс: прайс
короткий: коротким
классический: классический классические классической
нативный: нативных нативную
стать: статей
захватывать: захватывающих захватывать захватывающей захватывающий
больший: большая
интерактивный: интерактивных
миронычева: миронычева
продажа: продажа продаже
вами: вами
связаться: связаться
давать: дают
отправить: отправьте отправить отправленный
того: того
бесполезный: бесполезные
расскажите: расскажите
высокооплачиваемый: высокооплачиваемые
специальность: специальность
любом: любом
снова: снова
обязательно: обязательно
курс: курсы курсов
которыми: которыми
разработка: разработкой
автор: автор
спецпроект: спецпроектов
режиссёр: режиссёром режиссёров
монтажёр: монтажёр
цельный: цельное
сила: силы
обычный: обычных обычном
город: город
эпичный: эпичное
последовательность: последовательность последовательности
индустрия: индустрии
телевидение: телевидении
видеоблогинге: видеоблогинге
иметь: имеют
вкус: вкус
насмотренность: насмотренность
технический: технических технические
развивать: развивать
самостоятельно: самостоятельно
освоение: освоения освоение
пойти: пойдёт пошли
рассказать: рассказал расскажите
монтировать: монтировать
создавать: создавай
эффект: эффект
теория: теории
занимать: занимают занимая занимает
практический: практические практическими
итог: итоги
оказаться: окажется
экшен‑видео: экшен‑видео
ролик: ролик
метр: метр
интерьер: интерьера
изображение: изображения изображение
функциональный: функциональный функциональной функциональным
качество: качество
создать: созданные
по‑настоящему: по‑настоящему
комфортный: комфортном комфортное комфортная
эстетичный: эстетичную
обстановка: обстановку обстановка
сложно: сложно
получиться: получится получилось получившиеся получившийся
поэтому: поэтому
поручить: поручить
профессионал: профессионалов
разбираться: разбирается разбираться
тренд: трендах трендов
должный: должен должны
находить: находить находите находим
клиент: клиентами клиентом
продумывать: продумывать
где: где
разместить: разместить разместивший размещённого
электроника: электроника электроники
бытовой: бытовая
надёжный: надёжные надёжного
подрядчик: подрядчики
стройматериал: стройматериалы
добыть: добыть
зарабатывать: зарабатывать
создание: создания
одного: одного
лишь: лишь
безупречный: безупречного
необходимый: необходимо необходимые необходимую необходимый необходимое
программа: программа
проектирование: проектирования
вид: видам
отделочный: отделочных
переговоров: переговоров
учить: учат учит
опытный: опытных опытными
дизайнер: дизайнеры
реальный: реальные реальной
кейс: кейс кейсы
студент: студенты
полноценный: полноценный полноценного
дизайн‑проекты: дизайн‑проекты
закрытый: закрытому закрытым
профессиональный: профессиональных
комьюнити: комьюнити
способный: способны способен
любой: любые любого
пятёрка: пятёркой
язык: языке языков языку языка
немного: немного
написать: написать
статья: статью статье
информативной: информативной
продающей: продающей
драматургия: драматургию
ставить: ставить
представитель: представителей
целевой: целевой
аудитория: аудиторию аудитории
задание: заданиями
писать: писать
текст: тексты
тема: темы
описание: описаний
имейл‑рассылок: имейл‑рассылок
лендингов: лендингов
коммерческий: коммерческой коммерческие
seo‑оптимизацией: seo‑оптимизацией
основами: основами
формирование: формирования
контент‑стратегии: контент‑стратегии
овладеть: овладеть
длиться: длится
всего: всего
освоиться: освоиться
составить: составить
конкурентный: конкурентное
которое: которое
позволить: позволит позволят
заказ: заказе заказы
неплохой: неплохой
гонорар: гонорар гонорары
python‑разработчики: python‑разработчики
средний: средний средних
несложный: несложно
котором: котором
система: системы
искусственный: искусственная искусственные искусственной
некоторый: некоторых некоторое некоторые некоторым
главный: главная
преимущество: преимущество преимущества
лёгкость: лёгкости
знакомиться: знакомится
программирование: программированием программирования
запрос: запросов
версия: версии версиях
фреймворк: фреймворком
также: также
веб‑вёрстку: веб‑вёрстку
полгода: полгода
учёбы: учёбы
стажировка: стажировку
продакт‑менеджер: продакт‑менеджер
продакт‑менеджера: продакт‑менеджера
обеспечить: обеспечит обеспечено
безболезненный: безболезненный
успешный: успешный
обладать: обладает
управленческий: управленческими
метод: методах
сбор: сбор
готовый: готовы
постоянный: постоянной постоянных постоянным
подтвердиться: подтвердиться
рынок: рынке
спутать: спутать
карта: карты
конкурент: конкуренты
подобный: подобная
вызов: вызовы
опустить: опустит
искать: искать
вдохновлять: вдохновляя
команда: команду команда
ответственность: ответственность
конечно: конечно
маленький: поменьше
тоже: тоже
впечатлять: впечатляет
заказчик: заказчиков
минимально: минимально
жизнеспособный: жизнеспособный
анализировать: анализировать
управлять: управлять управляет управляют управляете
исследовать: исследовать
инженер: инженер
тестирование: тестированию тестирование
лагающие: лагающие
вылетать: вылетающие
страшный: страшный
сон: сон снов
недочёт: недочёты
дорого: дорого
обойтись: обойтись обошлась
неплохо: неплохо
предварительный: предварительных предварительного
жизнеспособность: жизнеспособности
приходить: приходят приходить
qa‑специалисты: qa‑специалисты
провести: провести
основательный: основательный
продумать: продумать
проверить: проверенных проверьте проверить проверим
возможный: возможные
тестировщику: тестировщику
алгоритм: алгоритмы алгоритмами
осуществление: осуществления
вручную: вручную
уровень: уровень
программу‑автотест: программу‑автотест
которая: которая
четыре: четыре
обучение: обучение
завершение: завершении
рассчитывать: рассчитывать
тестировщики: тестировщики
таргетолог: таргетолог
практически: практически
кампания: кампанию
соответствовать: соответствуют соответствует
интерес: интерес
потребность: потребностям потребность
пребывание: пребывания
заключаться: заключается
мастерский: мастерская
умение: умение
выстраивать: выстраивать
стратегия: стратегии
рекламодатель: рекламодателям
позволять: позволяет
эффективно: эффективно
продвижение: продвижение
обращаться: обращаться
заинтересованы: заинтересованы
таргетологов: таргетологов
адаптироваться: адаптировался
бонус: бонусов бонусами
основный: основные основного основным основной
знание: знаниям знанием
продавать: продающие
направление: направлений направлениях
медиа: медиа
сфера: сфера
строиться: строится
руководство: руководство
куратор: кураторов
сложность: сложности
опыт: опыт
смежный: смежных
сфере: сфере
сформировать: сформированы сформировав
легко: легко
освоится: освоится
внушительный: внушительный
учёбу: учёбу
оплачивать: оплачивать оплачивай
рассрочка: рассрочку рассрочкой рассрочки
шесть: шесть шестью
вообще: вообще
период: периода
трудоустроитесь: трудоустроитесь
начнёте: начнёте
собеседование: собеседовании
карьерный: карьерные карьерного карьерный
консультант: консультанты
получение: получение
вернёт: вернёт
действительный: действительны
стоимость: стоимостью
посмотреть: посмотреть
выделите: выделите
озадачивать: озадачивает
умереть: умереть
смех: смеха
кокетничать: кокетничать
зафрендить: зафрендить
заимствованные: заимствованные
глагол: глаголы
диплом: диплом
приравняют: приравняют
полный: полного полное полную
высокий: высокий высокая
каверзный: каверзных
склонение: склонении
числительный: числительных
существование: существование
поверить: поверить
спать: спать спящих
ссср: ссср
войсковой: войсковую
часть: часть
экстрасенс: экстрасенсов
неправильно: неправильно
норма: норм
мифический: мифических
прототип: прототипы
редкий: редких редкими
раз: раз
заваривать: заваривать
чайный: чайная чайных чайные
римский: римской
империя: империи
которым: которым
исчезнуть: исчезнуть исчезли исчезнувших
загадочный: загадочных
фразеологизм: фразеологизмов
происхождение: происхождение происхождения
выучить: выучить
английский: английский английскому английского
универсальный: универсальных
поражать: поражают
воображение: воображение воображения
существо: существ
когдато: когдато
ассоциироваться: ассоциируется
зелёный: зеленый
подделка: подделкой
внезапно: внезапно
превращаться: превращается
шпионский: шпионский
экшен: экшен
подволоцкий: подволоцкий
приключенческий: приключенческий
герой: героев
эванса: эванса
влюбляться: влюбляется
эдриан: эдриан
мо: мо
блейк: блейк
нельсон: нельсон
шакир: шакир
выступить: выступил
флетчер: флетчер
рокетмен: рокетмен
смотреть: смотреть
десерты: десерты
рулет: рулет рулеты
трайфл: трайфл
стаканчик: стаканчиках
шоколадный: шоколадные
сметанный: сметанным
крем: крем кремом
маффины: маффины
эклеры: эклеры
творожный: творожным
кейкпопсы: кейкпопсы
эскимо: эскимо
профитроли: профитроли
малиной: малиной
меренговый: меренговый
малина: малиной малины
панкейки: панкейки
итальянский: итальянский
имбирный: имбирные
пряник: пряников
спрятанным: спрятанным
роза: розы
бисквитный: бисквитный
ванильный: ванильные ванильным
шампанский: шампанским
масляный: масляным
самый: самый
роскошный: роскошный
кокосовый: кокосовые
трюфель: трюфели
чёрный: чёрного черная черный
лес: лес
вариация: вариации вариаций
сладкий: сладкая сладким сладкое сладкий
заменить: заменить
рисовый: рисового рисовый рисовые
нежный: нежная
праздничный: праздничного праздничный
пирожок: пирожки
вермишель: вермишелью
готовить: готовить
молоке: молоке
постный: постные
пирог: пироги пирогов
отличить: отличить
пасты: пасты
салаты: салаты
яичный: яичных яичные
блинчик: блинчиками
сырник: сырники
оригинальный: оригинальный оригинальном оригинального оригинальные
эклер: эклеры
грибной: грибные
дополнят: дополнят
гарниры: гарниры
любимый: любимый любимые любимого любимых
съедаться: съедаются
блинный: блинные
покорять: покоряют
ведьмак: ведьмака
рецепты: рецепты
полюбить: полюбить
сильнее: сильнее
ароматный: ароматные ароматным
поселятся: поселятся
соевый: соевый соевого
разнообразие: разнообразия
блин: блинов
мясной: мясные
цветной: цветные цветными
учётный: учётной учетная
потребоваться: потребуется потребовался
включать: включают
другого: другого
поставщик: поставщик
почта: почты почтой
переработать: переработала
почтовый: почтовый
оптимизировать: оптимизировав
интерфейс: интерфейс
соответствии: соответствии
изменение: изменения
календарь: календарь
встроенную: встроенную
продолжить: продолжить
выполнение: выполнения
остановиться: остановились
облегчать: облегчают
грандиозный: грандиозная
хью: хью
хауи: хауи
мире: мире
общество: общество общества
живёт: живёт
огромный: огромной
местный: местный местную
умирать: умирают
обстоятельство: обстоятельства
раскрывать: раскрывать
шокировать: шокирующие
секрет: секреты
фергюсон: фергюсон
иэн: иэн
побег: побег
шэйн: шэйн
макрей: макрей
премьер: премьер премьеры
стриминге: стриминге
состояться: состоится
сериаловантиутопий: сериаловантиутопий
изрядно: изрядно
понервничать: понервничать
замариновать: замариновать
авторский: авторских
севастьянов: севастьянова
вакуумный: вакуумный
незаменимый: незаменимая
мясоед: мясоедов
любитель: любителей
спонтанный: спонтанных
вылазка: вылазок
природу: природу
несколько: нескольких
чаша: чаша
рассчитать: рассчитана
л: л
овощи: овощи
гриб: грибы
ёмкость: ёмкости ёмкостью
вращаться: вращается
равномерно: равномерно
перемешивать: перемешивая
содержимое: содержимое
размягчаются: размягчаются
проникать: проникает
внутрь: внутрь
прибор: приборы
в: в
жареный: жареного жареные
острый: острого острый
игла: иглами
размягчать: размягчать
тендерайзер: тендерайзер
оснащён: оснащён
вливаться: вливается
впрыснуть: впрыснуть
кусок: кусок
ускориться: ускорится
сочный: сочнее сочная
бутылка‑трансформер: бутылка‑трансформер
перфекционистов: перфекционистов
компактно: компактно
хранить: хранить хранимый
комплект: комплект комплекте комплектов
восемь: восемь
мерный: мерный
воронка: воронка воронку
яйцерезка: яйцерезка
соковыжималка: соковыжималка
тёрка: тёрке
открывалка: открывалка
отделитель: отделитель
желтка: желтка
овощ: овощи
маслобойка: маслобойка маслобойку
аппарат: аппарат
масло: масла
остаться: остались останется оставшиеся оставшийся
жидкий: жидкую жидкой жидкие
нежнее: нежнее
насыщенный: насыщеннее насыщенные
объём: объём
исходный: исходного исходном
маркер: маркеров
пищевой: пищевых пищевую
узор: узоры
поверхность: поверхность
пирожных: пирожных
печение: печенья
раскрашивать: раскрашивать
маршмеллоу: маршмеллоу
тонкий: тонкие тонкий тонкими тонкой
гибкий: гибкая гибкой
линия: линии
регулироваться: регулируется регулируются
рисование: рисования
украшение: украшения
подаёт: подаёт
отвлекаться: отвлекаются
сосредоточиться: сосредоточиться
комплекте: комплекте
электрический: электрическим электрическая электрический
поставляться: поставляется
диспенсер: диспенсер
сыпучий: сыпучих
многие: многие
видеть: видеть
азиатский: азиатской
сторона: стороной
горох: гороха
прочих: прочих
что‑то: что‑то
крупнее: крупнее
макарон‑перьев: макарон‑перьев
помещать: помещать
удобный: удобный
единственный: единственные
подавать: подавать подают
комплектный: комплектный
контейнер: контейнер
расположенную: расположенную
корпус: корпусе корпуса корпусов
сковорода: сковорода сковороде
сковороду: сковороду
электросеть: электросети
диаметр: диаметр
одновременно: одновременно
размер: размером размере размеров
идеально: идеально
форма: форму форме
входить: входят входящих входит входить
деревянный: деревянной
распределять: распределять
переворачивать: переворачивать переворачивая
пеногенератор: пеногенератор
насыщать: насыщает насыщать
кислород: кислород кислорода
производитель: производителя производитель
счёт: счет
улучшаются: улучшаются
представлять: представляет представляете представляющим представляющий
себя: собой
горлышко: горлышко
бутылка: бутылкой бутылки бутылка
принцип: принципов
схожий: схож
аэратор: аэратором
малый: малый малой
гость: гостей гость
обычно: обычно
измельчение: измельчения
заморозить: замороженного
невозможный: невозможным невозможно
отрезать: отрезать
намазать: намазать
нож: ножом
отверстие: отверстие
закрыть: закрыть
крышка: крышкой
провернуть: провернуть
мелкий: мелкие мелкое мелком мелких мелкая
стружка: стружку
гораздо: гораздо
внимание: внимание
цена: цены
момент: момент
обновлять: обновлять обновляйте
оптический: оптические
иллюзия: иллюзии
слышать: слышим
поразному: поразному
одинаковый: одинаковых
кмс: кмс
удаётся: удаётся
чтото: чтото
потрогать: потрогать
сомнение: сомнения
отпадать: отпадают
привыкнуть: привыкли привыкнуть
ощущение: ощущение
потому: потому
этом: этом
меняться: меняется
была: была
обнаружить: обнаружена
герман: германом
гельмгольц: гельмгольцем
белый: белый белая
тёмный: тёмные тёмное
фон: фоне
бел: белом
учёные: учёные
разобраться: разобраться
чём: чём
зрительный: зрительной
нейрон: нейроны
чувствительный: чувствительные
выключать: выключающие
линейно: линейно
контраст: контраст контрастах
возбуждаются: возбуждаются
предсказуемо: предсказуемо
выделять: выделяя выделять
предмет: предметы предметами
тёмном: тёмном
особенность: особенность
выживать: выживать
далёкий: далёким
предкам: предкам
увеличивать: увеличивая увеличивают
объект: объекты
плохом: плохом
освещение: освещении
подкрадываться: подкрадывается
видный: видны
нужда: нужды
положено: положено
передавать: передают передаёт
визуальный: визуальная визуальные
дельбёфа: дельбёфа
внутренний: внутренним
изображении: изображении
левый: левый левыми левая
правый: правого правые правом
расстояние: расстояния
заставлять: заставляет
переоценивать: переоценивают
насыщение: насыщения
тарелка: тарелках
еда: еды
смотреться: смотрится смотреться
солиднее: солиднее
накладывать: накладывает
объедаться: объедается
подумать: подумать подумав
все: все
исчезновение: исчезновение
трокслера: трокслера
сконцентрироваться: сконцентрироваться
чёрном: чёрном
крестике: крестике
размытый: размытые
объясняться: объясняется
строение: строением
капилляры: капилляры
располагаться: располагаются
затенять: затеняют
перемещаться: перемещается
неподвижный: неподвижные
структура: структуры
капилляр: капилляры
целостный: целостное
затенить: затенённых
область: областей области
механизм: механизм
компенсация: компенсации компенсаций
фиксироваться: фиксируется
участок: участки участок участке участках
вырезаться: вырезаются
перестаёте: перестаёте
небольшой: небольшой небольшим небольшую
ведь: ведь
умолчание: умолчанию
периферия: периферии
злой: злую
фара: фары
автомобиль: автомобиля автомобиль автомобилей
влиять: влияет
говорить: говорить
слух: слух слухом
звуковой: звуковой звуковая
преодолеть: преодолеть
феномен: феномен
доказывать: доказывает
взаимосвязь: взаимосвязь
зрение: зрением
произносить: произносит произносят произносить
двигаться: двигаются
произнести: произнести
попробуйте: попробуйте
убедитесь: убедитесь
звук: звуками
ссорам: ссорам
последствие: последствий
связать: связанных
речь: речь
надвигающегося: надвигающегося
ближе: ближе
громкость: громкость громкости
снижаться: снижается
расположение: расположение
стремление: стремление
выжить: выжить выжил
приближаться: приближается
успеть: успеть успела успели
убежать: убежать
вкусовой: вкусовые
рецептор: рецепторы
указать: указанных указанной указаны
характерный: характерные
краситель: краситель
участник: участники участника
эксперимент: экспериментов
был: был
посуда: посуда посуды
продемонстрировать: продемонстрировало
горячий: горячий
кремовый: кремовой кремовые
оранжевый: оранжевой оранжевый
чашка: чашке чашкой
посуде: посуде
жёлтый: жёлтые
усиливать: усиливают усиливать
лимон: лимонов лимона
газировка: газировка
утолять: утоляет
жажда: жажду
розовая: розовая
предположить: предположить
нельзя: нельзя
тактильный: тактильные
резиновый: резиновую резиновая
кладёт: кладёт
стол: столы
ширма: ширмой
оставлять: оставляет оставляйте
убрать: уберите убрать
конечность: конечность конечностей
спрятанную: спрятанную
чувствовать: чувствовать
бьёт: бьёт
молоток: молотком
сильно: сильно
пугаться: пугается
особенно: особенно
переставать: перестаёт
тогда: тогда
видимый: видимая
нога: ноги
тёплый: тёплым тёплый
замедлять: замедляет
поступать: поступающей поступают
несовершенно: несовершенно
выясниться: выяснилось
форме: форме
тяжелее: тяжелее
учитывать: учитывайте учитывали
выбирать: выбирайте выбирает
искажение: искажения
правильный: правильно правильные правильный правильной
мифы: мифы
перехитрить: перехитрить
зря: зря
объективный: объективной объективные
существовать: существующих
деятельность: деятельности
сеть: сеть
территория: территории
анимация: анимации
комикс: комиксов
вольных: вольных
ведущий: ведущий
90‑х: 90‑х
человеке‑пауке: человеке‑пауке
любопытный: любопытные
широкий: широкой
мультфильмы: мультфильмы
доктор: доктор
стрэндже: стрэндже
рассказывать: рассказываем
пересмотреть: пересмотреть
поклонник: поклонники
музыке: музыке
подписывайтесь: подписывайтесь
слушать: слушать
стрэндж: стрэндж
мультивселенной: мультивселенной
совмещать: совмещает
яркий: яркий
пацан: пацаны
культовый: культовое
которого: которого
благородство: благородство
семья: семьи семьям
моллюск: моллюск моллюсков
дмитрий: дмитрий
нередко: нередко
называть: называют называть
аристократический: аристократического
крестьянин: крестьяне
загорать: загорали
бледный: бледная
неё: неё
были: были
голубоватый: голубоватые
вена: вены
самая: самая
выражение: выражений выражения
аристократ: аристократы
кальмары: кальмары
синекольчатый: синекольчатый
придаёт: придаёт
содержать: содержать содержащих содержащий
железо: железо железа
переносить: переносить
головоногие: головоногие
дальше: дальше
эволюционный: эволюционном
другой: другой
сохранить: сохранить
старый: старые
привычный: привычные
находиться: находится
гемолимфе: гемолимфе
членистоногий: членистоногих
использоваться: используются используется
перенос: переноса
жабр: жабр
кожа: кожи
эффективнее: эффективнее
вода: воды
вязкий: вязкой
довольно: довольно
артериальный: артериальное
давление: давление
превышать: превышать
мм: мм
ст: ст
медь: медь
синий: синий синей
кровеносный: кровеносная
вполне: вполне
поменьше: поменьше
дыхании: дыхании
жабра: жабры
последний: последнем последний последней последних
выключаться: выключается
плавать: плавает
переутомляться: переутомляется
предпочитать: предпочитают
плыть: плыть
краб: крабов
состав: состав
осьминожьей: осьминожьей
окрасить: окрашены
фиолетовый: фиолетовый фиолетовая
совершенно: совершенно
воробей: воробей
впереди: впереди
камышенко: камышенко
пират: пираты
карибский: карибского
море: море
длительность: длительность
доллар: долларов
встречать: встречает
забыть: забыл забыть
месть: месть
королева: королевы королева
анна: анны
борода: борода
отправляться: отправляются
вечный: вечной вечного
расход: расходы расходов
окупиться: окупились
миллиард: миллиарда
понятно: понятно
уйти: ушли уйти
звёзды: звёзды
крус: крус
циммер: циммера
эра: эра
старком: старком
выходить: выходя
из‑под: из‑под
уничтожить: уничтожить уничтожен уничтожила
человечество: человечество
вынуждены: вынуждены
объединиться: объединиться
противостоять: противостоять
помешать: помешать
близнец: близнецы
пьетро: пьетро
вижн: вижн
неизвестный: неизвестная неизвестно
сущность: сущность
успех: успех успеху успехов
мститель: мстителей
220‑миллионном: 220‑миллионном
выделить: выделено выделенной
россыпь: россыпь
звёзд: звёзд
передовой: передовые
спецэффект: спецэффекты
предыдущий: предыдущих предыдущего предыдущую предыдущие
сражение: сражению сражения
поражение: поражения
победить: победить
враг: врага врагами врагом
число: числе
пожертвовать: пожертвовать
дольше: дольше
потратить: потраченные
лихвой: лихвой
путь: путь
салли: салли
воспитывать: воспитывает
пандоре: пандоре
идиллия: идиллия
заканчиваться: заканчивается
вновь: вновь
жена: женой жене
мигрировать: мигрирует
пандоры: пандоры
вступать: вступает
племя: племя
вынужденный: вынужден
жить: жить
иных: иных
точный: точная точной
условный: условна
кэмерон: кэмерон
снять: снял
третий: третьим третьем третья
четвёртый: четвёртая
подорожать: подорожают
судить: судя
инвестиция: инвестиции
оправдаться: оправдались
бесконечность: бесконечности
межгалактический: межгалактический
злодей: злодей злодеев
камень: камней камни
мировой: мировое
господство: господство
рискнуть: рискнуть
разрушение: разрушения
коммерчески: коммерчески
превысить: превысили
элизабет: элизабет
уилл: уилл
тёрнер: тёрнер
объединяться: объединяются
барбоссой: барбоссой
снаряжать: снаряжают
идёт: идёт
продолжение: продолжение
справедливость: справедливости
брюс: брюс
уэйн: уэйн
преступность: преступностью
отряд: отряд
флэш: флэш
киборг: киборг
опасность: опасность
возникнуть: возникших возникнуть
считаться: считается
доработка: доработку
из‑за: из‑за
смерть: смерти
дочь: дочери дочерью
джоссом: джоссом
негативный: негативную
перемонтировать: перемонтировал
отснять: отснятый
интереснее: интереснее
соло: соло
звёздный: звёздные
война: войны
бросать: бросает бросают
служба: служба службы службами
имперский: имперском
ввязывается: ввязывается
преступник: преступник
чубаккой: чубаккой
путешествовать: путешествует
вселенным: вселенным
преступление: преступление
возлюбленной: возлюбленной
родный: родной родные
следствие: следствием
режиссёра: режиссёра
ховард: ховард
переснять: переснял
подготовить: подготовленного
фил: филом
лорд: лордом
кристофер: кристофером
миллер: миллером
франшиза: франшизы
фанат: фанаты
провал: провал
списывать: списывают
скайуокер: скайуокер
восход: восход
трилогия: трилогии
скайуокеров: скайуокеров
очередной: очередной
вспоминать: вспоминают вспоминаете
прошлое: прошлое
треворроу: треворроу
абрамс: абрамс
итоговый: итоговой
вырасти: вырос
затрата: затраты
отзыв: отзыв
эксплуатация: эксплуатацию эксплуатации
оказываться: оказывается
попадать: попадает
сбежать: сбежать
принцесса: принцессу
влюбиться: влюбился
провалиться: провалился
картина: картины
киностудия: киностудии
подать: подал
интересно: интересно
тепло: тепло
принять: принять принял принятым
кассовый: кассовых
скандальный: скандальных
устать: устал устала
банальный: банальных
выдающийся: выдающимися выдающихся выдающиеся
диалог: диалог
привидение: привидениями
звёздным: звёздным
актёрский: актёрским
король: король короля
мёртвый: мёртвого
третьем: третьем
дэдпуле: дэдпуле
росомах: росомах
обратить: обратить
байопик: байопик
вернуть: вернуть
ужас: ужасов
пэн: пэн
миллы: миллы
пропустить: пропустили пропустите пропустить
лассо: лассо
триллер: триллер
кассель: кассель
порусски: порусски
везде: везде
триумфатор: триумфатором
премия: премии
гильдия: гильдии
киноактёр: киноактёров
биографический: биографических
неожиданный: неожиданной
алексей: алексей
серебряков: серебряков
биться: бьётся
тайге: тайге
тьма: тьмы
нечто: нечто
убивать: убивает
психбольница: психбольницы
мелочь: мелочи
застёжкой: застёжкой
кнопка: кнопках
элегантный: элегантным элегантных элегантное
замена: заменой
вязаный: вязаному
зимнему: зимнему
шарф: шарфу
изготовить: изготовлена
вискоза: вискозы
полиэстер: полиэстера
шерсть: шерсти
твид: твид
сочетаться: сочетается
пиджак: пиджаками
шейный: шейный шейного
поздний: поздней
прикрывать: прикрывать
холод: холода
шея: шею
цветочный: цветочным цветочный
принтом: принтом
образам: образам
яркость: яркости
шёлк: шёлка
носить: носить носимых
гладкий: гладкой
махровый: махровой
разнообразить: разнообразить
образ: образом
сшить: сшита сшиты
приятный: приятный
ощупь: ощупь
комплектация: комплектации
тянуться: тянутся
ломать: ломают
волос: волос волосы
ободок: ободок
обладательницам: обладательницам
длинный: длинный
эффектный: эффектного
трёх: трёх
цвет: цветах цветами
розовый: розовом розовой
бежевый: бежевом
браслет: браслет
ниткой: ниткой
золотистых: золотистых
застёжка: застёжке
изящно: изящно
сочетать: сочетать
серьга: серьги
пусеты: пусеты
ювелирный: ювелирного
золотой: золотым золотого золотая золотое
покрытие: покрытием
инкрустировать: инкрустированы
кристалл: кристаллами
хрусталь: хрусталя
подвеской: подвеской
броский: броский
длина: длина
морковка: морковка морковки
ботвой‑кристаллами: ботвой‑кристаллами
бижутерного: бижутерного
брошь: брошь
декорировать: декорированная
весенний: весеннее весеннего весенняя
пластиковый: пластикового
крупный: крупным крупный крупных крупного крупная
лаконичный: лаконичной
милый: милого
сверкающий: сверкающими
глазами‑кристаллами: глазами‑кристаллами
подвесить: подвесить
качестве: качестве
ключ: ключ
описании: описании
превратить: превратить
люверс: люверсы
шопер: шопер
вместительный: вместительная
молния: молнии
поход: походов похода
покупка: покупками покупкой
пляж: пляж
выбор: выбор
поясной: поясная поясных
продаётся: продаётся
двух: двух
расцветка: расцветках
рептилия: рептилии
нарядный: нарядной
застёгиваться: застёгивается
магнитный: магнитную
затягиваться: затягивается
увесистый: увесистая
связка: связка
звенеть: звенеть
шаг: шаг шаги шагов
натуральный: натуральной
компактный: компактный
поездка: поездки поездку поездка
займёт: займёт
прочный: прочного прочные
прогибаться: прогибаться
изменчивый: изменчивый
издательство: издательство
выгорание: выгорания выгоранию
медицинский: медицинских медицинской медицинским медицинское
кроль: кроль
предложить: предложить
состояние: состояния
публиковать: публикуем
отрывок: отрывок
шестой: шестой
глава: главы
турбулентность: турбулентности
лебедь: лебедей
сильный: сильной сильнейшее сильна сильным сильного
страх: страх
неупорядоченность: неупорядоченность неупорядоченности
менять: меняет меняют
фокусировка: фокусировку
снижать: снижает
оказывать: оказывающих оказывать оказываемых
потенциально: потенциально
разрушительный: разрушительное разрушительным
воздействие: воздействие воздействия
внешний: внешней внешнем
резонировать: резонирует
мирный: мирное мирные
убаюкивать: убаюкивать убаюкивает
становиться: становится
раб: рабом
сохранять: сохранять
способность: способность
принимать: принимает
верный: верным
поделюсь: поделюсь
перенапряжение: перенапряжения
суеты: суеты
тревога: тревога тревоги тревогой
спокойствие: спокойствие
собранность: собранность
эффективность: эффективности эффективностью
событие: событий
тобой: тобой
туда‑сюда: туда‑сюда
приспособишься: приспособишься
показаться: покажется
нашёл: нашёл
похожий: похожих
геолокацию: геолокацию
быстром: быстром
перемещение: перемещении
непрерывно: непрерывно
энергия: энергия
привязка: привязки
значительно: значительно
сориентироваться: сориентироваться
обусловливать: обусловливает
быстрый: быстрых
расходоваться: расходуются
попытка: попытки попытке
выработать: выработать
советовать: советую советуют
непредсказуемость: непредсказуемость
жёсткость: жёсткость
распорядок: распорядка распорядок
поведение: поведение
иллюстрироваться: иллюстрируется
задраенной: задраенной
ореховый: ореховой
скорлупка: скорлупки
стихия: стихия
кидать: кидает кидая
орех: орех
вверх: вверх
вниз: вниз
невредимый: невредимым
сожаление: сожалению
плохо: плохо
описывать: описывает
во‑первых: во‑первых
равный: равно
во‑вторых: во‑вторых
чёткий: чёткие
творческий: творческом
самое: самое
скорее: скорее
сравнить: сравнить
жёсткий: жёстким
ветер: ветром
выдержать: выдержит
сломаться: сломается
усилить: усилить
вовне: вовне
чистый: чистого чистые чистым чистая
внутри: внутри
искренне: искренне
безмятежный: безмятежным
финансы: финансы
увольняться: увольняются
попытаться: попытаться
сдерживать: сдерживать
искусственно: искусственно
сжимать: сжимать
зуб: зубы
спровоцировать: спровоцируешь спровоцировать
прямой: прямая
упорядочение: упорядочения
упорядочить: упорядочить упорядочена упорядочено
разложить: разложить
безусловно: безусловно
полезное: полезное
выстоять: выстоять
удаться: удастся
железный: железного
фашистский: фашистского
рейх: рейха
оперативно: оперативно
выявляться: выявлялись
жестоко: жестоко
караться: карались
дело: делах
развал: развал
частный: частной частном
соблюдать: соблюдать
ощущать: ощущать
противоречие: противоречия
выше: выше
фоновый: фоновая
телесный: телесном телесную
эмоциональном: эмоциональном
когнитивный: когнитивном когнитивные
сочетание: сочетанию сочетанием сочетания сочетаниями сочетаниях
перевозбуждение: перевозбуждения
навязчивый: навязчивых навязчивой
мысль: мысли
невозможность: невозможность невозможностью
расслабление: расслабления
мышцах: мышцах
завязать: завязан завязать
комок: комок комками
готовность: готовности готовность
отчётливый: отчётливой
разрядка: разрядки
суета: суета
мельтешение: мельтешение
затрагивать: затрагивающий
эмоция: эмоции
впустую: впустую
перевозбуждённым: перевозбуждённым
внутренне: внутренне
скованный: скованным
приоткрыть: приоткрыть
утроенной: утроенной
скорость: скорости
непредсказуемо: непредсказуемо
порядку: порядку
скованность: скованности скованность
гибкость: гибкость
смочь: сможет сможете
обрести: обрести
беречь: беречь
активный: активными активные активный активных активного
навязывать: навязывает
поспешный: поспешных
откладывание: откладывания
конфликт: конфликтов
разрыв: разрывов
ненужный: ненужные ненужных ненужной
растерянность: растерянности
желание: желанию
поскорее: поскорее
пристать: пристать
неважный: неважно
ложный: ложного
наладится: наладится
антивыгорательные: антивыгорательные
установить: установленного установленной
войти: войти вошёл
пульсировать: пульсировать
мерцать: мерцать мерцающие
невесомость: невесомости
проявлять: проявлять
активность: активности
рамка: рамках
движение: движение движения движений движениями
вперёд: вперёд
обеспечивая: обеспечивая
начнём: начнём
направить: направленных направить
разработать: разработали разработанного
отвечать: отвечает отвечающие отвечают
данное: данное
отвоевать: отвоевать
жаловаться: жалуется жалуются
валя: валя
выясняться: выясняется
формировать: формирует
черпать: черпая
глобальный: глобальной
локальный: локальные локальным локальными локальном
повестка: повестку
случиться: случилось случиться
мной: мной
знакомых: знакомых
пространство: пространство пространстве
нагромождение: нагромождениями
обдумать: обдумать
прочувствовать: прочувствовать
сверху: сверху
валиться: валятся
контролировать: контролирует
создаёт: создаёт
опускаться: опускаются
думскроллинге: думскроллинге
непрерывный: непрерывный
отдельно: отдельно
прокрастинация: прокрастинации
пребывать: пребывают
тревожный: тревожные
дисциплинировать: дисциплинировать
воздерживаться: воздерживается
думскроллинга: думскроллинга
погружаться: погружается
типичный: типичное
думскроллинг: думскроллинг
перешибать: перешибает
увлечённости: увлечённости
рутина: рутины
повседневность: повседневность
переформатировать: переформатирует
странно: странно
кощунственно: кощунственно
агрессия: агрессии агрессию
погружать: погружает
бессилие: бессилие
вводить: вводить
нейрохимический: нейрохимический
привыкать: привыкает
извращённое: извращённое
бессилия: бессилия
перенастраиваться: перенастраивается
эмоциональный: эмоционального
удовлетворять: удовлетворяют удовлетворяет
информированный: информированное
кофе: кофе
бесконечный: бесконечного
отнимая: отнимая
предлагать: предлагая
конструктивный: конструктивными конструктивные
пронаблюдайте: пронаблюдайте
овладевать: овладевает
утренний: утреннего утренние
входной: входными
воротами: воротами
определённый: определённый определённой
приёмный: приёмные
чётко: чётко
остальное: остальное
дальнейший: дальнейшим дальнейшем
пункт: пункт пункте
инструкция: инструкции
подавленность: подавленность
подвижность: подвижность
игнорирование: игнорирования
возбуждение: возбуждения возбуждением
поймать: поймав
достаёте: достаёте
приготовленную: приготовленную
расправить: расправить
плечо: плечи
крылья: крылья
панцирь: панциря
черепаха: черепахи
что‑нибудь: что‑нибудь
малозначительный: малозначительное
окно: окном
примерно: примерно
полтора: полторы
умственный: умственную
требовать: требуют требует
порция: порцией
перевести: перевести
бормотание: бормотании бормотание
живём: живём
прерыватель: прерывателей
скрыть: скрыто скрыть скрытых
взор: взора взором
понадобиться: понадобится понадобятся
учиться: учится
водить: водить
регулярный: регулярные регулярной
паузы: паузы
сложиться: сложившуюся сложилось сложившиеся
инерция: инерцию
пробивать: пробиваемую
неформальный: неформальная
болтовня: болтовня
экран: экрана
планировать: планируем планируйте планируете планируешь
регулярно: регулярно
нравиться: нравится
сегодня: сегодня
победа: победы
зло: злом
привыкнете: привыкнете
совершить: совершит
ясный: яснее
принятие: принятия принятие
прерывание: прерывания
чтение: чтения
воспоминание: воспоминания
мобилизовать: мобилизуем
управляемый: управляемыми управляемая
прыгать: прыгать
дозировать: дозировать
переживание: переживания переживанием
этику: этику
юмор: юмор
соображение: соображения
сумеете: сумеете
отделить: отделить
сопереживать: сопереживать
критичный: критичными критичного
радикально: радикально
известиями: известиями
печаль: печалью
выдерживать: выдерживать
хаос: хаос хаоса
скроешься: скроешься
страус: страусами
взаимодействие: взаимодействия
ужасным: ужасным
выпускать: выпускать выпускает выпускают
взаимодействовать: взаимодействовать
текущий: текущих текущий
записывать: записывайте
услышать: услышали
выражать: выражает
старайтесь: старайтесь
почувствовать: почувствовать
горе: горе
заплакать: заплакать
вспомнить: вспомнив
испугаться: испугаться
оцепенение: оцепенении
забывать: забывай
шевелиться: шевелитесь шевелиться
отвлекайтесь: отвлекайтесь
дышите: дышите
чай: чая
перечитывать: перечитывайте
пережить: пережили пережить
укрощаете: укрощаете
отнять: отнять
тренировать: тренируйте
переключаемость: переключаемость
культивировать: культивировать
переключение: переключения
состояниями: состояниями
пассивность: пассивностью пассивности
рассредоточенность: рассредоточенностью
делаться: делается
владеть: владеть
пейзаж: пейзажем
переключаемости: переключаемости
восстановить: восстановить
расслабленно: расслабленно
потянуться: потянулись
пятнадцать: пятнадцать
горевание: горевание
несбывшихся: несбывшихся
конкретный: конкретного конкретное
шаги‑ступени: шаги‑ступени
просмотр: просмотра
семь: семь
собираетесь: собираетесь
даёте: даёте
активно: активно
отчаиваться: отчаиваться отчаиваюсь
переключаетесь: переключаетесь
отчаяние: отчаяния
белок: белками
потенциальный: потенциальным потенциальной
работодатель: работодателям
посадить: посадить
претендовать: претендует
всецело: всецело
разрушая: разрушая
граница: границы
мысленно: мысленно
скоро: скоро
оглядка: оглядкой
оплакать: оплакать
выбираться: выбираться
никогда: никогда
неоформленный: неоформленное
сбивчивый: сбивчивое
спешить: спешащее спешить
управляемость: управляемость
чувствующими: чувствующими
перейдём: перейдём
решать: решать
горизонт: горизонт горизонте
усилие: усилий
изобретать: изобретать
основа: основе
руководствоваться: руководствуетесь
полагаться: полагаетесь
интуиция: интуицию интуиции
приходиться: приходится
терять: теряешь
равновесие: равновесие
предсказать: предсказать
останавливаться: останавливаются
подсказывать: подсказывают
безнадёжность: безнадёжности
рациональный: рациональными рациональная
подождём: подождём
вовсе: вовсе
замереть: замерли
упуская: упуская
метаться: мечутся
суетятся: суетятся
сколь: сколь
угодно: угодно
рационально: рационально
определяться: определяется определяются
настроение: настроением
спокойный: спокойные
беспокойный: беспокойные
грустно: грустно
тревожно: тревожно
пропасть: пропасть
боевой: боевого
уверены: уверены
побеждать: побеждать
другая: другая
ошибочный: ошибочной ошибочные
верной: верной
срочно: срочно
подскочить: подскочила
вдвое: вдвое
максимальный: максимальной
выехать: выехать
собраться: собраться
комфорт: комфортом
уезжать: уезжать
неверный: неверных
поправка: поправку поправки
парализованным: парализованным
мечущимся: мечущимся
расслабиться: расслабиться
выкинуть: выкинуть
допускать: допускаю допускать
ответы: ответы
показывать: показывают показывали
поладить: поладить
продиктованные: продиктованные
вероятность: вероятность
жалеть: жалеть
опираться: опираясь
ценность: ценности ценностей ценностях
плясать: плясать
дудка: дудку
принятии: принятии
какой‑либо: какой‑либо
моём: моём
прошлом: прошлом
своём: своём
выборе: выборе
хвалить: хвалил хвалят
проявленное: проявленное
хладнокровие: хладнокровие
быстроту: быстроту
проницательность: проницательность
хитрость: хитрость
иными: иными
чаще: чаще
поспешить: поспешив
хладнокровно: хладнокровно
выждали: выждали
диктовать: диктует
данной: данной
приоритет: приоритеты
ориентир: ориентиры
бояться: боитесь бойтесь боится
вера: вера
христиан: христиан
мощный: мощная
крепость: крепости
актуализировать: актуализировать
иили: иили
сковало: сковало
каковы: каковы
какие‑то: какие‑то
угроза: угрозы
вырисовываться: вырисовывающиеся
рассматривать: рассматривать рассматриваемые
уголок: уголком уголок
касаться: касающихся
лично: лично
интуитивный: интуитивная
самой: самой
обобщение: обобщения обобщение
основание: основании основанием основания
постичь: постичь
неудача: неудач
крайний: крайней
мера: меры
определить: определить определенного
экспресс‑методы: экспресс‑методы
необязательно: необязательно
кое‑что: кое‑что
отмечать: отмечает
рекомендовать: рекомендую
краткосрочный: краткосрочной
перспектива: перспективе
адаптация: адаптацию
трижды: трижды
рулём: рулём
расслабить: расслабьте расслабить
закройте: закройте
успокойте: успокойте
дыхание: дыхание
зрительных: зрительных
прозрачный: прозрачный прозрачным
ложкой: ложкой
чаинка: чаинки
взлетать: взлетают
медленно: медленно
оседать: оседать
стая: стая
чаёк: чаек
снежинка: снежинки
метель: метель
хоть: хоть
броуновский: броуновское
вообразить: вообразить
роятся: роятся
мельтешить: мельтешат
сталкиваться: сталкиваются
кувыркаются: кувыркаются
пусть: пусть
складываться: складывается
волна: волны
лицо: лицам лицом
молекула: молекулы
раскладывать: раскладывать
песок: песка
чередовать: чередуйте
успокаивать: успокаивающие
сами: сами
продолжать: продолжая
дополнить: дополнить
материальный: материальных материальные
поднос: поднос
высыпаться: высыпается высыпаемся
крупа: крупы
необязательный: необязательно
реалистичный: реалистичные
крупинкам: крупинкам
ассоциировать: ассоциируйте ассоциируете
разнообразный: разнообразными разнообразные
навязанными: навязанными
пульсирующем: пульсирующем
навязанного: навязанного
выполнять: выполнять выполняйте
отрывать: отрывая
кривой: кривые
раскрасьте: раскрасьте
замкнуть: замкнутые
контур: контуры
вдумчиво: вдумчиво
пустой: пустыми
абстрактный: абстрактная
самодельный: самодельной
антистресс‑раскраски: антистресс‑раскраски
даёт: даёт
медленный: медленного
аккуратный: аккуратного
рисовать: рисовать
спонтанно: спонтанно
бесконтрольно: бесконтрольно
произвольный: произвольного произвольная
точность: точности
медитация: медитации
постарайтесь: постарайтесь
целенаправленно: целенаправленно
ассоциация: ассоциациям ассоциацией
распутывая: распутывая
упорядочивать: упорядочивая
задействующий: задействующий
танец: танцы
выдохните: выдохните
концентрироваться: концентрируясь
поворачивать: поворачивать
поднимать: поднимать поднимаю
вращать: вращать вращаю
кисть: кистями
вслух: вслух
проговаривать: проговаривать
растопыривать: растопыриваю
плавно: плавно
два: двух
захотеться: захочется
неосознанно: неосознанно
максимально: максимально
отпустить: отпустить
дёргать: дёргайте
подпрыгивать: подпрыгивайте
оборачиваться: оборачивайтесь
ложиться: ложитесь
перекатываться: перекатывайтесь
нелепый: нелепые
поза: позы
зажимы: зажимы
травма: травм травма
осторожно: осторожно
раскрепоститься: раскрепоститься
получаться: получается
шаманский: шаманской
пляска: пляски
плавный: плавными
умиротворяющими: умиротворяющими
постойте: постойте
отдача: отдачей
запрограммированных: запрограммированных
объяснение: объяснений
долой: долой
рационализировать: рационализировать
обобщить: обобщить
концептуализировать: концептуализировать
далее: далее
безошибочно: безошибочно
столкнуться: столкнулись
чем‑то: чем‑то
неординарный: неординарным
сработают: сработают
напряжённость: напряжённости
по‑прежнему: по‑прежнему
борьба: борьба борьбы
мнение: мнению мнений мнением
верх: верх верху
виноватых: виноватых
выразить: выразить
гнев: гнев
понятный: понятно понятными
трудный: трудные трудных труднее трудное
разговаривать: разговаривать
непродуктивный: непродуктивным
плодотворным: плодотворным
иссушать: иссушающим
хуже: хуже
испортить: испортить
сотрудничество: сотрудничества
перессориться: перессориться
череда: череда
параметр: параметры параметров
обращать: обращать
атмосфера: атмосферу атмосфера
отложить: отложить
поговорить: поговорить
коммуникация: коммуникации
проверять: проверяйте проверяет
беседа: беседы
доля: доля
существенно: существенно
высоко: выше
особенный: особенных
таковой: таковой
продавить: продавить
продать: продать
интонация: интонации
фраза: фразы
установка: установке
важнее: важнее
общаться: общаться общаются
сущностный: сущностном
смысловой: смысловом смысловой
процессуальный: процессуальном
вскипание: вскипанием
превратиться: превратился превратились
обмен: обмен
монолог: монологами
оценками: оценками
сравнениями: сравнениями
введение: введением
вина: вины
повышать: повышает повышают
абстрагирование: абстрагирование
конкурирующую: конкурирующую
навязывание: навязывание
скрытый: скрытая
обобщать: обобщать
деталям: деталям
случайный: случайные случайного
напряжённый: напряжённые
проблемный: проблемные
менее: менее
вскользь: вскользь
дистанция: дистанцию
снижение: снижение снижению
плотность: плотности
слабак: слабаком
давить: давить давящую
силовой: силовое
стратегический: стратегического стратегический стратегическим
выигрыш: выигрыша
тактический: тактический
наделать: наделать
вежливость: вежливости
плотный: плотным плотный плотной
расставлять: расставлять
впускать: впускать
воздух: воздух воздуха
улыбка: улыбка
пауза: паузы
ускорение: ускорения
голос: голос голосом
важность: важности
срочность: срочности
профилактика: профилактике
переоценить: переоценить
малозначащей: малозначащей
симпатизировать: симпатизирую
научимся: научимся
обрывать: обрывать
невербальный: невербальные
завязываются: завязываются
легче: легче
координата: координаты
уходить: уходить
масса: масса массу
расти: расти
решить: решить
исходить: исходя исходит
оба: обе
способствовать: способствуют
отыскать: отыскать
делиться: делятся делимся
самодиагностики: самодиагностики
проверенные: проверенные
стойкость: стойкость
трезвый: трезвую
избавлять: избавляют
улучшить: улучшить
сойти: сойти
неопределённо: неопределённо
тревожность: тревожностью
оля: оля
ёгидэ: ёгидэ
одеть: одеть
искупать: искупать
накормить: накормить
капризный: капризного
умываться: умываться
20х: 20х
бьютитренды: бьютитренды
соцсетях: соцсетях
переписка: переписки
родительский: родительский
этичный: этичным
парадоксальных: парадоксальных
жизненный: жизненных
обручальный: обручальное
кольцо: кольцо кольцами
закипеть: закипела
мозг: мозгом
подросток: подростков
развивающих: развивающих
добиться: добились
участвовать: участвовать
марафонах: марафонах
врать: врать
лжём: лжём
заполнить: заполнить
профиль: профиль
блог: блоге
платье: платья платье
книжный: книжных
увлекать: увлекают
телевизионный: телевизионных
беспокоиться: беспокоиться
издавать: издаваемых
гиперфокус: гиперфокус
пересказ: пересказы
зарубежный: зарубежных
сравнение: сравнения
несчастный: несчастными
нарушение: нарушений
грязный: грязные
переговорах: переговорах
выпить: выпить
вырастить: вырастить
роман: романов романе
послушать: послушать
запоминать: запоминать
другому: другому
художественный: художественных художественный
мыслить: мыслить
раздаёт: раздаёт
навсегда: навсегда
надоесть: надоесть
духовке: духовке
индийский: индийском
шашлычки: шашлычки
кукурузный: кукурузной
хлопьями: хлопьями
отбивные: отбивные
лимонный: лимонный
кускус: кускусом
пряность: пряностями
запечённое: запечённое
медовый: медовой
тушенная: тушенная
томатный: томатной томатную
тушёный: тушёные
суфле: суфле
чеснок: чеснок чесноку
имбирём: имбирём
грудка: грудка грудки грудку
помидорами: помидорами
шампанское: шампанского
духовка: духовку духовке
паприка: паприкой
фаршированные: фаршированные
жюльен: жюльен
рулетики: рулетики
гениальный: гениальное
дарья: дарья
громов: громова
питтсбургский: питтсбургского
конференция: конференции
организовать: организует организовать
американский: американской
кардиологический: кардиологической
записаться: записался
12месячную: 12месячную
соответствие: соответствия
рекомендуемому: рекомендуемому
потребление: потреблению
калория: калорий
данные: данные
отчёты: отчёты
самих: самих
кровать: кровати
продолжительность: продолжительность
удовлетворение: удовлетворение
пробуждение: пробуждения
пол: пол полов
расу: расу
партнёра: партнёра
выявить: выявили выявит
оценка: оценкой
групповой: групповые
питаться: питались
предел: пределах
посвятить: посвящены
идти: идёт
предпринимать: предпринимать предпринимают предпринимает
голод: голод
метаболизм: метаболизм
склонность: склонность
доказательство: доказательств
увеличение: увеличению
ход: ходе
доброволец: добровольцами добровольцев
расширить: расширить
выборка: выборку
возможно: возможно
мотивация: мотивацию
лицевой: лицевая
вильтовский: вильтовский
фанатская: фанатская
модификация: модификация модификацию
разработчик: разработчиков
видеоигра: видеоигры
моддеры: моддеры
портал: портал порталы
обновить: обновить
рубино: рубино
мод: мод
актёра: актёра
дэниел: дэниела
рэдклиффа: рэдклиффа
приближён: приближён
нимбус2000: нимбус2000
брутальный: брутальной
усмотрение: усмотрение усмотрению
причёска: причёску
игровой: игровые игровой игровых
ранее: ранее
гермиона: гермионы
ждём: ждём
тварь: тварь
мем: мемами
дар: дары даром
стартовать: стартовала
русском: русском
факультет: факультет
пьяница: пьяницу пьяница
фэнтези: фэнтези
нейросети: нейросети
коллекция: коллекцию коллекции коллекция
продлить: продлил
список: списком
запрещённых: запрещённых
одобренных: одобренных
выживалку: выживалку
раздавать: раздаёт
атмосферный: атмосферное
скачать: скачать
открывать: открываешь открывать открывая
баннер: баннеры баннеров
японский: японские японского японский
консоль: консолей
геймплейный: геймплейный
инсайдер: инсайдер
оторвать: оторвать оторванных
зарицкая: зарицкая
посещение: посещения
торжественный: торжественного
ночной: ночного
дневный: дневного
искусственном: искусственном
перламутровый: перламутровые
придать: придать
выразительность: выразительности
приглушённом: приглушённом
подчеркнуть: подчеркнут
замаскировать: замаскировать
избегать: избегать
обратный: обратной
смешать: смешать
какуюто: какуюто
изюминка: изюминку
остальной: остальной
переборщить: переборщить
толщина: толщиной
слой: слоя слой
избыток: избыток
естественность: естественность
положить: положить положив
румян: румян
относиться: относится относящиеся относящихся
декоративный: декоративной
косметика: косметике
следить: следить
дневного: дневного
простор: простор
колористический: колористических
вряд: вряд
платью: платью
блёстками: блёстками
скула: скулы
блеск: блеск
размазывалось: размазывалось
качественный: качественные качественных
наложенная: наложенная
ресница: ресницы
стечь: стёкшая
придавать: придаёт придают
подходить: подходящую подходящими
тщательно: тщательно
растушёвывать: растушёвывайте растушёвывать
поглядывать: поглядывать
нарушать: нарушающим нарушать
классика: классику классики
айс: айс
добавлять: добавляет добавляйте
большинство: большинство большинства
беспроигрышный: беспроигрышный беспроигрышным
этакое: этакое
варьировать: варьировать
тень: теней
ярче: ярче
скромнее: скромнее
приклейте: приклейте
накладный: накладные
соблазнительный: соблазнительным
густой: густых густой
ленточные: ленточные
удобнее: удобнее
клеить: клеить
попрактикуйтесь: попрактикуйтесь
вечеринка: вечеринкой вечеринок
смелый: смелый
яркосиняя: яркосиняя
осторожность: осторожностью
выразительный: выразительными
пройдитесь: пройдитесь
стрелка: стрелки
прорисуйте: прорисуйте
зрительно: зрительно
завлекательный: завлекательную
кошачий: кошачью
графичные: графичные
вариант: варианты
подводка: подводкой
растушёванные: растушёванные
мода: мода
блестеть: блестящие блестящий
акцентировать: акцентирует
чёрной: чёрной
склонный: склонны
экспериментировать: экспериментировать
сухой: сухой сухими сухого
влажный: влажной
серёг: серёг
нарисовать: нарисовать
век: веках
блёстка: блёстки
переливом: переливом
игривый: игривые
костюмированный: костюмированную
любить: любит
пользоваться: пользуются
фиксировать: фиксирующим фиксируют фиксированной
спреем: спреем
лице: лице
покрасьте: покрасьте
классик: классика
ограничиваться: ограничиваясь
приобретать: приобретать
гигиенический: гигиеническую
анджелина: анджелины
бейкинг: бейкинг
дрейпинг: дрейпинг
гайд: гайд
ухаживать: ухаживать
расчёсками: расчёсками
стеллаж: стеллаж
рассада: рассады
дарить: дарить
обидеть: обидеть
кошка: кошек
фишер: фишер
сажать: сажать
львиный: львиный
рассаду: рассаду
гибдд: гибдд
лягушкой: лягушкой
правильнее: правильнее
диспепсия: диспепсией
самостоятельный: самостоятельное
переедать: переедает
перепивать: перепивает
гастроэзофагеальная: гастроэзофагеальная
рефлюксная: рефлюксная
гэрб: гэрб
злокачественный: злокачественная злокачественных
опухоль: опухоль
варьироваться: варьироваться
сохраняться: сохраняющееся сохраняются
набитый: набитого
дискомфорт: дискомфорт
жжение: жжение
верхний: верхней верхнем
вздутие: вздутие
отрыжка: отрыжка
вызвать: вызвано вызовите вызванных
переедание: перееданием
заглатывание: заглатыванием
жирный: жирной жирная
злоупотребление: злоупотреблением
кофеин: кофеин
газированными: газированными
курение: курение
вставать: встаёт
приёма: приёма
нестероидный: нестероидных
противовоспалительный: противовоспалительных
язва: язвы
заболевание: заболеваний
опорожнение: опорожнения
нём: нём
гастропарезом: гастропарезом
атония: атонией
нерв: нервов
диабет: диабета
неврологический: неврологических
расстройство: расстройств
соединительный: соединительной
осложнение: осложнениями
операция: операции
скорый: скорую
одышка: одышку
потливость: потливость
отдающую: отдающую
инфаркт: инфарктом
настораживать: настораживать
признак: признаки признакам
потеря: потеря потерю
частый: частая частые
затруднение: затруднение
глотании: глотании
медикаментозной: медикаментозной
симптомы: симптомы
возникать: возникают возникающих
исчезать: исчезают
покое: покое
указывать: указывает указывая
злокачественные: злокачественные
сходить: сходите сходить
сдать: сдать сдал
анализ: анализы
углублённый: углублённое
гастроскопия: гастроскопию
несварение: несварении
кливлендский: кливлендской
безрецептурное: безрецептурное
фермент: ферменты
изжога: изжоги
разбавить: разбавить разбавьте
пить: пить
расшириться: расширился
усугубиться: усугубились
чисто: чисто
теоретически: теоретически
пройтись: пройтись
прилечь: прилечь
положенный: положено
придерживайтесь: придерживайтесь
рекомендация: рекомендаций
триггер: триггеров
забрасывать: забрасывать
кислый: кислое
беспокойство: беспокойство
усугублять: усугубляет
болеть: болеть
голодный: голодный голодная
ком: ком
горле: горле
понизить: понизить
кислотность: кислотность
читатель: читателями читателей
свёкор: свёкру
праздновать: празднуют
масленица: масленицу
уместный: уместными
отпраздновать: отпраздновать
поднять: поднимут
влюбить: влюблённых
отметить: отметить
годовщина: годовщины
свадьба: свадьбы
сын: сыну
класс: класс
запоминаться: запоминающихся
наградить: награждены
телешоу: телешоу
стиллера: стиллера
драматический: драматическое драматическом
шоу: шоу
медведь: медведь
комедийный: комедийный
номинация: номинации
минисериалов: минисериалов
эпизод: эпизод
хитростях: хитростях
адаптированный: адаптированный
основать: основанная
одноимённом: одноимённом
мириам: мириам
фабельманов: фабельманов
объявить: объявлены
журнал: журнала
корпорация: корпорация
опрашивать: опрашивает опрашиваемых
киноделов: киноделов
когдалибо: когдалибо
иллюстрация: иллюстрация
одиссея: одиссея
половина: половиной половины
пепел: пепел
кейн: кейн
сельский: сельского
священник: священника
сальватор: сальваторе
туманный: туманной
луна: луны
дождь: дождя
головокружение: головокружение
опросить: опрошенный
уэс: уэс
андерсон: андерсон
внести: внёс
десятка: десятку десятки
кадр: кадры
словосочетание: словосочетания словосочетание
блеснуть: блеснуть
безукоризненный: безукоризненным
воронцов: воронцова
филолог: филолог филологи филологов
лексический: лексическая
речевой: речевом
исторически: исторически
комбинируются: комбинируются
логический: логического
словоупотребление: словоупотребления
справочниках: справочниках
словарях: словарях
естественный: естественным
путём: путём
пособие: пособия
носитель: носителей
авторитетный: авторитетным
словарь: словарь словари
редакция: редакции редакциями
денисов: денисова
морковкина: морковкина
появляться: появляются
путать: путают путайте
смешивать: смешивают
кругозор: кругозор
переносный: переносное
представление: представления
окинуть: окинуть
здесь: здесь
подразумеваться: подразумевается
горизонтальный: горизонтальная
плоскость: плоскость
предок: предков
интересовать: интересовало
следовательно: следовательно
понятие: понятия
вертикаль: вертикалью
ошибочно: ошибочно
приложить: приложить
распространённая: распространённая
предпринять: предпринять предпринятых
коренной: коренной
москвич: москвич
неправильный: неправильной
закоренелый: закоренелый закоренелая
чём‑то: чём‑то
нехорошем: нехорошем
предрассудок: предрассудки
предвидеть: предвидеть
предвкушать: предвкушать
несчастие: несчастье
означать: означает
испытывать: испытывать испытываем
чего‑либо: чего‑либо
ожидать: ожидаем
неприятный: неприятных
раннем: раннем
глубокий: глубокая глубоком глубокий
аналогия: аналогии
прилагательное: прилагательное
зима: зимой зимы
лето: летом
юность: юностью
обречённый: обречён
ждёт: ждёт
несчастье: несчастье
гибель: гибель
средство: средством средствами
передать: передать
ирония: иронию
антоним: антонимы
обоими: обоими
неудачный: неудачного неудачных неудачными
разговорный: разговорной
допустимый: допустимо
значение: значении
выделяющийся: выделяющийся
положительный: положительными
отрицательный: отрицательными отрицательных
исключительный: исключительных
застолье: застолья застольем
даля: даля
толковый: толковом
устареть: устаревшего
стоить: стоить
сырьё: сырьё
покупается: покупается
низкий: низкая
нормальный: нормальное
словаре: словаре
употреблять: употребляем
антонимы: антонимы
лексикон: лексиконе
кавказский: кавказская
пленница: пленница
мастер: мастеров
ремесло: ремёсел
рождаться: рождаются
порой: порой
очень: очень
долгий: долгий
множество: множеством
сабреддит: сабреддит
демонстрировать: демонстрирует демонстрирующим
творениями: творениями
выполненными: выполненными
ряд: ряд
устойчивый: устойчивый устойчивые устойчивыми
мыльница: мыльница
автомобильный: автомобильные
держатель: держатель
подставка: подставка
домик: домик
дереве: дереве
дверь: дверью
попросить: попросили
стойка: стойка
камера: камеры камерой
плинтус: плинтусы
эстетично: эстетично
дезодорант: дезодоранта
пульт: пульт
кофейный: кофейный
бокал: бокалов
финальный: финальное
автосервис: автосервис
строительство: строительства строительство
ремонт: ремонтом
чужой: чужие
поступок: поступки
стыдно: стыдно
фотография: фотографии фотографий
питомец: питомцев питомцы
джоэл: джоэлом
серия: серии
джентльмены: джентльмены
сгенерировала: сгенерировала
жизнеупрощатель: жизнеупрощатель
иностранный: иностранных
исполнение: исполнением исполнения
перенести: перенесла
викторианский: викторианскую
эпоха: эпоху
довёл: довёл
депрессивный: депрессивных
стимпанк: стимпанк
питание: питании
перестараться: перестарался
угадать: угадать
киногероя: киногероя
фиаско: фиаско
разорительный: разорительных
фейлов: фейлов
80х: 80х
симпсоны: симпсоны
ситком: ситкомом
покемон: покемонов
постсоветский: постсоветском
дизайн: дизайны
впечатлить: впечатлить
раздражение: раздражение
татуировка: татуировки
покрыть: покрытая покрытого покроет
обманчиво: обманчиво
перри: перри
данным: данным
облёт: облёт
юноной: юноной
минимальный: минимальны минимальным
тысяча: тысяч
километр: километров
обработанные: обработанные
детализация: детализацией
исходник: исходников
уточняться: уточняется
пиксель: пикселя
обработанном: обработанном
фильтр: фильтра
устранить: устранить
ожидаться: ожидается
детальный: детальные
спутнике: спутнике
проекте: проекте
тренды: тренды
хозяйничать: хозяйничать
изба: избы
задаваться: задаются
нарнию: нарнию
желаниях: желаниях
кошельке: кошельке
классное: классное
раис: раиса
выпускница: выпускница
байер: байер
продвигать: продвигает продвигать продвигают
осознанный: осознанный
подход: подход
уникальный: уникальный уникальная
несочетаемый: несочетаемыми
распродажа: распродажа
бренд: бренды
аутлеты: аутлеты
посвящён: посвящён
дресскода: дресскода
базовый: базовому
составлять: составлять составляют составляющие
разбор: разборы
тенденция: тенденций
осознать: осознанный осознанное
экология: экологии
отход: отходов
капсульный: капсульный
минималист: минималистам
гора: гору горы
стильный: стильными стильная стильного стильную стильные
экологично: экологично
избавляться: избавляться
реже: реже
качественнее: качественнее
индивидуальность: индивидуальность
основательница: основательница
начинаться: начинается
подробный: подробные подробное
инфографики: инфографики
схема: схемы
призванный: призванные
сумкабагет: сумкабагет
формула: формула
тайна: тайны
васильев: васильев
размышлять: размышляет
веяние: веяния
сопровождать: сопровождать сопровождают
потрясающие: потрясающие
пошаговый: пошаговый пошаговое
трансформация: трансформации
госс: госс
блогер: блогер блогера
подчёркивать: подчёркивает
показать: показать
маскировать: маскирует
спрятать: спрятать
инесса: инесса
трубецкова: трубецкова
цветовой: цветовых
имиджмейкеры: имиджмейкеры
подбирать: подбирать
наряд: нарядах
симулировать: симулируют
сайрус: сайрус
иванов: иванова
мужейальфонсов: мужейальфонсов
домогательство: домогательств
неравный: неравных
женугнетательниц: женугнетательниц
перегиб: перегибы
начаться: начнется началась
казахстане: казахстане
мирнова: мирнова
молодец: молодец
спорный: спорных спорные
устраивать: устраивали
консерватор: консерваторы
традиционалист: традиционалисты
солидарный: солидарны
одном: одном
стремиться: стремимся
остальных: остальных
конец: конце концов
грех: греха
незначительный: незначительной
токсичность: токсичности
яндексдзен: яндексдзен
размещённых: размещённых
джинсы: джинсы
подручный: подручными
традиционный: традиционных традиционный
запрет: запреты
страна: странах
викинг: викингов
хейтят: хейтят
героиня: героиню
элли: элли
экранизация: экранизации
прелюдия: прелюдия
рыбы: рыбы
серёжеккаффов: серёжеккаффов
шикарных: шикарных
полнолуние: полнолуние
знаменовать: знаменующее
взойти: взойдёт
вторник: вторник
московский: московский
противоположный: противоположной
солнечный: солнечный
лунный: лунный
яркооранжевым: яркооранжевым
объёмный: объёмным
неслучайно: неслучайно
отражать: отражает
оттаивать: оттаивающей
просыпаться: просыпаться
земляные: земляные
черви: черви
луной: луной
честь: честь
полевой: полевых
цвести: цвести
район: районах районе
северный: северной северная
стричь: стричь
полететь: полететь
именинница: именинницы именинница
мартынов: мартынов
родственница: родственницу
сосредоточьтесь: сосредоточьтесь
минималистичный: минималистичный
плетёный: плетёном
чемодан: чемодане
альт‑пласта: альт‑пласта
садовый: садовых садовая садовый
свекровь: свекровь
проводить: проводить
рассмотреть: рассмотреть
складный: складные складных складного складной
походный: походные
набор: наборы
испортятся: испортятся
влага: влаги
четырёх: четырёх
стул: стульев
уход: уход
любительница: любительнице
выращивать: выращивать
подоконнике: подоконнике
порадует: порадует
ящик: ящике
пять: пяти
три: трёх трех
комнатный: комнатной
растение: растений
выращивание: выращивания
тепличный: тепличная
конструкция: конструкция конструкцию
светильник: светильник
секция: секциями
микрозелени: микрозелени
сэкономить: сэкономить сэкономьте
чемоданчик: чемоданчик
органайзер: органайзеры
подвесной: подвесную подвесной
полками‑чехлами: полками‑чехлами
данный: данный
загромождать: загромождая
разномастный: разномастными
коробка: коробками
отделение: отделениями
робот‑пылесос: робот‑пылесос
ежедневный: ежедневной ежедневном
ручной: ручной
станцией‑баком: станцией‑баком
мусор: мусора
хозяйка: хозяйке
придётся: придётся
выбрасывать: выбрасывать
скопиться: скопившуюся
контейнере: контейнере
бюджетный: бюджетные
очищать: очищать
справляться: справляются
литература: литературы
объёмной: объёмной
дисплеи: дисплеи
чернилами: чернилами
бумажный: бумажные бумажной
усталость: усталости
планшет: планшеты
смарт‑часы: смарт‑часы
цифровой: цифровую цифровой
отслеживать: отслеживать
сообщение: сообщения сообщений
доставать: доставая
отпариватель: отпариватель
приводить: приводить
штора: шторы
текстиль: текстиля
утомительный: утомительной
облегчить: облегчит
вертикальный: вертикальный
подсветка: подсветкой
регулировать: регулируемой регулирует регулирующими
присоской: присоской
ванный: ванной
премиальный: премиальные
процедура: процедур процедуры
настраиваемую: настраиваемую
косметический: косметические
регулировкой: регулировкой
высота: высотой высоты
ножкой: ножкой
присоска: присоске
капельный: капельная
рожковый: рожковая
капельная: капельная
мультипекарь: мультипекарь
сменный: сменными
пригодится: пригодится
омлет: омлета
вафель: вафель
блендер: блендер блендера
кулинарный: кулинарная
продемонстрируете: продемонстрируете
коктейль: коктейли коктейль
выберите: выберите
чашей: чашей
стационарный: стационарный
измельчитель: измельчителем измельчитель
беспроводной: беспроводной
разделочный: разделочная
приспособление: приспособление
вещица: вещицы
торцевой: торцевая
разноцветный: разноцветных
упаковщик: упаковщик
запас: запасы
продолжительный: продолжительный продолжительного
срок: срок
ужин: ужинов
расходник: расходников
восстанавливаться: восстанавливаться
различный: различные различных
воздействовать: воздействовать
вибрация: вибрацией
плечи: плечи
поясница: поясницу
перкуссионный: перкуссионный
массажёр: массажёр
аромадиффузор: аромадиффузор
ароматический: ароматических
распылитель: распылителем
диффузор: диффузор
увлажнителем‑диффузором: увлажнителем‑диффузором
ультразвуковой: ультразвуковой
подсвечник: подсвечником
комфорте: комфорте
пижаму: пижаму
ткань: тканей
потеряется: потеряется
полоска: полоску
котиком: котиком
растительный: растительным растительного
кимоно: кимоно
компания: компания компании
соревнование: соревнование
эрудиция: эрудицию
распитие: распитием
средневековье: средневековье
колонизатор: колонизаторы
каркассон: каркассон
эффектно: эффектно
упаковать: упаковать
практичный: практичных практичные
развлечь: развлекут развлечь
впечатление: впечатление
ребёнку: ребёнку
книжка: книжек
домашний: домашнему
классификация: классификация
должность: должности должность
переводчик: переводчик
яндексмузыке: яндексмузыке
скрупулёзно: скрупулёзно
заваливать: заваливать
сверхурочный: сверхурочной
коллективе: коллективе
дружелюбный: дружелюбной
всему: всему
отменять: отменяет
грусть: грусти
разочарование: разочарования
уходе: уходе
воодушевление: воодушевление
общении: общении
соосновательницы: соосновательницы
рекрутинговый: рекрутингового
агентство: агентство агентстве
гиллиан: гиллиан
уильямс: уильямс
аморальный: аморальное
неэтичный: неэтичное
противозаконный: противозаконное
отказываться: отказываться
весомый: весомая
увольнение: увольнения
ухудшение: ухудшение
мгновенно: мгновенно
незнакомый: незнакомый
коллектив: коллектив
поискать: поискать
многогранный: многогранны
несоответствие: несоответствие
недопонимании: недопонимании
руководитель: руководителем руководители руководитель
нужное: нужное
нос: нос
минда: минда
хартс: хартс
босс: босс
достоинство: достоинством
перепробовать: перепробовали
сработать: сработало
предварительно: предварительно
перерыв: перерыв
подушка: подушку
план: планах
всём: всём
стандартный: стандартных стандартный стандартного
заблаговременно: заблаговременно
оповестить: оповестить
очередь: очередь
деталь: деталей
требование: требованиям требований
темп: темп
оценивать: оценивать
побольше: побольше
непосредственно: непосредственно
оцениваться: оценивается
рост: роста
душевный: душевное душевный
необдуманный: необдуманного
переполнять: переполняют
служебный: служебный
навыка: навыка
круча: круче
спокойно: спокойно
огне: огне
алёны: алёны
владимирский: владимирской
повеселиться: повеселиться
погрустить: погрустить
клоун: клоуном
лерикой: лерикой
пивненколукиной: пивненколукиной
токсичный: токсичные
интроверт: интроверт
экстраверт: экстраверт
плюс: плюс
четырёхдневный: четырёхдневной
шахматах: шахматах
аудионастроек: аудионастроек
клавиатуры: клавиатуры
переработанное: переработанное
настройка: настроек настройку настройки настройках
попрежнему: попрежнему
пространственным: пространственным
клавиатура: клавиатуры
иконка: иконку
стабильный: стабильная
сборка: сборку сборке сборки
процессор: процессорами процессором
принудительно: принудительно
устанавливать: устанавливает
мессенджер: мессенджера мессенджеры
отображать: отображать
системный: системные
полноэкранный: полноэкранных
конце: конце
наблюдаться: наблюдаются
сбой: сбои
подписка: подписку подпиской
графический: графический
операционный: операционной
опрос: опрос
диспетчере: диспетчере
интеграция: интеграцию интеграций
пуск: пуск
энергосбережение: энергосбережению
панель: панель
очистка: очистки
обещанными: обещанными
поставить: поставьте
пароль: пароль
спросить: спросить
многом: многом
китайский: китайский
тестировать: тестирует тестировать
смартустройствах: смартустройствах
погоде: погоде
неожиданно: неожиданно
ассистент: ассистента
далёк: далёк
беспроводный: беспроводные
электрохромными: электрохромными
перезапустить: перезапустят
отечественный: отечественного отечественных
росатом: росатом
минипк: минипк
бобёр: бобёр
флагманский: флагманские
аккумулятор: аккумулятором
титановый: титановый
уменьшить: уменьшенный
выступ: выступ
электросамокат: электросамокат
двойной: двойной
подвеска: подвеской
увеличивающимся: увеличивающимся
ремонтировать: ремонтировать
рендеры: рендеры
ультрабюджетный: ультрабюджетный
мп: мп
увлажнитель: увлажнитель
мойка: мойка
очиститель: очиститель
распродаже: распродаже
охота: охоты
комплектующие: комплектующие
доступный: доступным
недорого: недорого
прибрести: прибрести
комфортно: комфортно
жаркий: жаркую
дышащего: дышащего
пенный: пенного
подстраиваться: подстраивается
стопа: стопы
скользкий: скользкими
поверхностями: поверхностями
амортизирующая: амортизирующая
рельефный: рельефным
протектор: протектором
маломерит: маломерит
заказать: заказать
осмысленный: осмысленной
стараться: стараемся
излагать: излагать
запросто: запросто
пройдёте: пройдёте
многое: многое
благодарность: благодарность
миссия: миссия
несовершенство: несовершенство
замотивировать: замотивировать
научить: научить
хлама: хлама
пожиратель: пожирателей
толпа: толпы
серость: серости
призыв: призыв
мечтать: мечтать
смелее: смелее
формулировка: формулировками
псевдонаучности: псевдонаучности
непонятный: непонятных
термин: терминов
игнорировать: игнорируем
происшествие: происшествия
религия: религию религии
неофициальный: неофициальные
заявление: заявления
законопроект: законопроекты
пропаганда: пропагандой
редакционный: редакционные
стандарт: стандарты
подробно: подробно
описать: описаны
вдохновляться: вдохновляйтесь
благо: благо
цитировании: цитировании
перепечатка: перепечатке
задаём: задаём
мотивировать: мотивируем
перемена: перемены переменам
издатель: издатель
пономарь: пономарь
шефредакторы: шефредакторы
рубцовамонзани: рубцовамонзани
редактор: редакторы
наталья: наталья
родионов: родионова
сукманова: сукманова
корректоры: корректоры
сытник: сытник
новостной: новостной
олеся: олеся
синицын: синицына
исполнительный: исполнительный
пчёлкин: пчёлкина
развитие: развитию
краснов: краснов
лера: лера
бабицкая: бабицкая
гапеев: гапеева
артём: артём
козориз: козориз
курачёва: курачёва
копылов: копылова
сахаров: сахарова
кирилл: кирилл
винницкий: винницкий
костючкова: костючкова
присоединяться: присоединяйтесь
осмыслить: осмысленной
тендер: тендерам тендерах тендеров
креативный: креативное креативные креативный
молодой: молодая молодым
амбициозный: амбициозная
мегафон: мегафон
сбербанк: сбербанк
продакшеном: продакшеном
торговый: торговые торговых торговым
тендерный: тендерных
мониторить: мониторить
государственный: государственный
заявка: заявок заявки заявку заявке
участие: участия участие
объявленных: объявленных
аукцион: аукционах
торг: торгов
целесообразность: целесообразности
себестоимость: себестоимость
подготавливать: подготавливать
конкурсный: конкурсные
этп: этп
контракт: контракты
подписать: подписанных
договор: договоров
подразделение: подразделениями
аккредитация: аккредитацию
площадка: площадках
подпись: подпись
отчётность: отчетность отчётность
законодательный: законодательной законодательными
база: базой
поисковый: поисковых
контрактный: контрактных
заказной: заказная
аутсорсинг: аутсорсинг
навыки: навыки
юридический: юридический юридического
документация: документацией
пожалуйста: пожалуйста
официальный: официальное официальная
подписывать: подписываем
документ: документы
itкомпания: itкомпания
восьмичасовой: восьмичасовой
воскресение: воскресенье
выходной: выходные
удалёнка: удалёнка
доход: дохода
тыс: тыс
руб: руб
выигранного: выигранного
забота: заботы
сотрудник: сотрудниках сотрудником
корпоративный: корпоративного корпоративное
гаджет: гаджеты
иллюстратор: иллюстратор иллюстраторами
обсуждаться: обсуждается
собеседовании: собеседовании
иллюстрировать: иллюстрировать
союз: союзе
приветствоваться: приветствуется
сжатый: сжатых
адекватный: адекватная адекватные адекватной
удалённо: удалённо
релевантный: релевантных релевантный
постановка: постановки
реализованный: реализованным
грамотность: грамотность
деловой: деловой
коммуникабельность: коммуникабельность
обучаемость: обучаемость
ему: ему
круто: круто
таблицами: таблицами
изложить: изложить изложенных
забрифовать: забрифовать
оставить: оставьте
фидбэк: фидбэк
15летней: 15летней
ежемесячно: ежемесячно
монолитный: монолитного
окружённого: окружённого
микросервисами: микросервисами
методология: методологии
таймтрекеры: таймтрекеры
гордиться: гордимся
проектировать: проектировать
поддерживаемый: поддерживаемый
qaинженерами: qaинженерами
терминал: терминалом
phpфреймворками: phpфреймворками
заработный: заработной
плата: платы
frontendпрограммист: frontendпрограммист
продуктовый: продуктовую
уверенный: уверенные
адаптивный: адаптивной
кроссбраузерной: кроссбраузерной
вёрстка: вёрсткой
анимациями: анимациями
cssпрепроцессорами: cssпрепроцессорами
ценить: ценим
уважение: уважение
инициативность: инициативность
самостоятельность: самостоятельность
осуществлять: осуществляет
специфика: специфике
г: г
ульяновск: ульяновск
digitalспецпроектов: digitalспецпроектов
прийти: прийти пришло
отдел: отделу
нацеленность: нацеленность
бюрократию: бюрократию
имя: имя
номер: номер
файл: файл файла
тестовый: тестовое
комментирования: комментирования
рад: рады
общайся: общайся
беларуская: беларуская
гороскопы: гороскопы
настроить: настроить
раздумьях: раздумьях
круп: круп
маркеры: маркеры
принадлежность: принадлежности принадлежность
человекапаука: человекапаука
достора: достора
стрэнджа: стрэнджа
результативный: результативных
равиля: равиля
дильшод: дильшод
людмила: людмила
эрик: эрик
альбом: альбомов
cdataобразование: cdataобразование
cdataдарья: cdataдарья
ве: ве
cdataбытовая: cdataбытовая
cdataкухонные: cdataкухонные
cdataтовары: cdataтовары
cdataиллюзии: cdataиллюзии
cdataоптические: cdataоптические
cdataмихаил: cdataмихаил
вольный: вольных
cdataподкасты: cdataподкасты
cdataмультфильмы: cdataмультфильмы
cdataживотные: cdataживотные
cdataинтересные: cdataинтересные
cdataфильмы: cdataфильмы
национальный: национальной
бизнескоммуникаций: бизнескоммуникаций
леднёва: леднёва
cdataпрессрелизы: cdataпрессрелизы
маркетолог: маркетологов
маркетинговый: маркетинговых
экспертный: экспертного
трёхэтапного: трёхэтапного
голосование: голосования
cdataжизнь: cdataжизнь
cdataборьба: cdataборьба
cdataвыгорание: cdataвыгорание
трудность: трудностями
cdataстрах: cdataстрах
бесподобный: бесподобным
cdataздоровье: cdataздоровье
утверждённому: утверждённому
ооо: ооо
буферный: буферная
администрация: администрацией администрации
правило: правилами
неотъемлемый: неотъемлемой
обязательный: обязательным обязательными обязательна обязательное обязательного
посетитель: посетителей
фактический: фактического
пользование: пользования
добавление: добавление
какого‑либо: какого‑либо
уведомление: уведомления
внесение: внесения
согласный: согласны
презюмируется: презюмируется
термины: термины
программный: программного программное
ввести: введённых
аутентификационный: аутентификационные
странице: странице
интеллектуальный: интеллектуальной интеллектуальных
приравнять: приравненные
литературный: литературные
эвм: эвм
телефон: телефонов телефону
аудиовизуальный: аудиовизуальные
фонограмма: фонограммы
товарный: товарные
обслуживание: обслуживания
обозначение: обозначения
фирменный: фирменные фирменной
логотипы: логотипы
гипертекстовый: гипертекстовые гипертекстового
фрагмент: фрагменты
виджеты: виджеты
иные: иные
размещать: размещая размещать
модерация: модерация
предусмотреть: предусмотренных
достоверный: достоверной
авторизация: авторизации
добровольно: добровольно
безвозмездно: безвозмездно
фамилия: фамилию
вправе: вправе
храниться: хранятся хранится
сервер: серверах серверы
политикой: политикой
включая: включая
предоставляться: предоставляется
хранимые: хранимые
обеспечение: обеспечения обеспечение
несёт: несёт
сохранность: сохранность сохранностью
нести: несёт
гарантировать: гарантирует
передача: передача передачи
умышленно: умышленно
неосторожность: неосторожности
осуществить: осуществить
раскодирование: раскодирование
невыполнение: невыполнения
информационный: информационных
желать: желает желающим желающие
настоящем: настоящем
просьба: просьбой
информирование: информирования
обязываться: обязуется
немедленно: немедленно
неразрешённом: неразрешённом
незамедлительно: незамедлительно
несоблюдение: несоблюдения
предоставление: предоставления предоставлению
указание: указанием
регистрационный: регистрационной
обращение: обращения обращении
выдавать: выдавать
логин: логин
нецензурный: нецензурным
бранный: бранным бранные
оскорбительный: оскорбительные
дискриминационный: дискриминационным
неуместный: неуместным
общепринятый: общепринятой общепринятые
мораль: морали
нравственность: нравственности
заимствовать: заимствовать
логины: логины
изменять: изменять изменяют
подтверждать: подтверждает
правоспособность: правоспособностью
дееспособность: дееспособностью
исполнять: исполнять
соглашаться: соглашается
произведённые: произведённые
расцениваться: расцениваются
повлечь: повлечь
предоставлять: предоставляет предоставляют
добровольный: добровольное
стимулировать: стимулирующих
направлять: направлять
функционирование: функционировании функционирование функционирования
отказать: отказать
содержание: содержание
загружать: загружает
отправлять: отправляет отправляйте
передаёт: передаёт
каким‑либо: каким‑либо
пользовательпосетитель: пользовательпосетитель
расценить: расценены
недостоверный: недостоверные
незаконный: незаконных незаконным
размещая: размещая
нему: нему
для: для
нахождение: нахождения
вредоносный: вредоносным
угрожать: угрожающим
оскорблять: оскорбляющим оскорблять
противоречить: противоречащим противоречащих
клеветнический: клеветническим
собственность: собственности собственность
пропагандировать: пропагандирующим пропагандировать
жестокость: жестокость
дискриминация: дискриминацию
расовый: расовому расовой
этнический: этническому
половой: половому
религиозный: религиозному религиозной религиозные
имущественный: имущественному
порнография: порнографии порнографию
эротика: эротики
разъяснять: разъясняющим
изготовление: изготовления
иного: иного
наркотический: наркотических
вещество: веществ
аналог: аналогов
взрывчатый: взрывчатых
оружие: оружия оружие
этика: этику
затруднять: затрудняющим затрудняющих
несовершеннолетний: несовершеннолетних
ущемление: ущемления
меньшинство: меньшинств
выдача: выдачи
законодательство: законодательством
другую: другую
вирус: вирусы
предназначить: предназначенные предназначенного предназначенных
уничтожение: уничтожение
функциональность: функциональности
телекоммуникационный: телекоммуникационного
оборудование: оборудование
несанкционированный: несанкционированного
серийный: серийные
генерация: генерации
пароли: пароли
прочие: прочие
платный: платным платных
вышеуказанный: вышеуказанный вышеуказанные вышеуказанных
каких‑либо: каких‑либо
международный: международного международными международный
государство: государства
грубый: грубые
непристойный: непристойные
ненормативный: ненормативные
автоматизировать: автоматизированных
соответствующий: соответствующего соответствующие
перезапись: перезапись
содействие: содействия
нежелательный: нежелательной
совершение: совершения
вмешательство: вмешательством
либо: либо
вознаграждение: вознаграждения
фиктивный: фиктивные
рейтинг: рейтинге
объявление: объявление объявлений
адресовать: адресованных
неограниченный: неограниченному неограниченное
иной: иной
принести: принесёт
убыток: убытки
моральный: моральный
ущерб: ущерб
репутация: репутации
достижение: достижении
обязанность: обязанностей обязанности
рассмотрение: рассмотрением
разрешение: разрешении
спор: споров
конфликтный: конфликтных
мотивированный: мотивированных
некорректный: некорректное
данного: данного
уполномоченный: уполномоченным уполномоченный
целом: целом
приостановить: приостановить
приостанавливать: приостанавливать
проведение: проведения
плановый: плановых
профилактический: профилактических
ремонтный: ремонтных
привлекать: привлекают
воспроизведение: воспроизведение
доведение: доведение
всеобщий: всеобщего
распространение: распространение
целиком: целиком
исключение: исключением
полномочие: полномочиями полномочий
недостоверность: недостоверности
гарантия: гарантии
лицензия: лицензию
переработку: переработку
выплата: выплаты
размещённый: размещённый
образовать: образующих образует
организация: организацией
архивный: архивные
передаче: передаче
удаление: удаление
свободный: свободное
ознакомление: ознакомления ознакомление
некоммерческий: некоммерческих
единый: единый
соблюдение: соблюдению
обязать: обязана
посещать: посещают
оказать: оказать оказанные
толковать: толковать
размещённую: размещённую
размещённым: размещённым
контент: контентом
содержимому: содержимому
убытков: убытков
возместить: возместить
причинённый: причинённый
объёме: объёме
возмещение: возмещение
судебный: судебном
издержка: издержек
какие‑либо: какие‑либо
обязательство: обязательства
ответчик: ответчиков
возмещать: возмещает
могущих: могущих
перебой: перебоями
заключительный: заключительные
недействительный: недействительным недействительными
толкуется: толкуется
урегулировать: урегулированные
возникновение: возникновения возникновении
уполномоченном: уполномоченном
сопровождаться: сопровождаться
препятствовать: препятствовать
признаёт: признаёт
реквизиты: реквизиты
ул: ул
этаж: этаж
местонахождение: местонахождения
огрн: огрн
инна: инн
кпп: кпп
связанный: связанным
аффилированными: аффилированными
оператор: оператору
поддомен: поддоменов поддоменах
неприкосновенность: неприкосновенность
федеральный: федеральным
распространяться: распространяется
обрабатывать: обрабатывает обрабатываемых
применение: применением
утверждение: утверждения
подлежать: подлежащих
раскрытие: раскрытие
размещаться: размещается
общедоступный: общедоступным общедоступными
передающими: передающими
относящаяся: относящаяся
косвенно: косвенно
определяемому: определяемому
субъект: субъекту субъекты
муниципальный: муниципальный
совместно: совместно
данными: данными
совокупность: совокупность
извлечение: извлечение
блокирование: блокирование
автоматизированный: автоматизированная автоматизированным
вычислительный: вычислительной
неопределённый: неопределённому
временной: временное
уничтожаться: уничтожаются
содержащихся: содержащихся
сокращённое: сокращённое
оказание: оказанием
конкурс: конкурсов
законный: законных
правовой: правовые правовым
хранение: хранением
обработкой: обработкой
федерация: федерации
принципы: принципы
заявленным: заявленным
полномочиям: полномочиям
достоверность: достоверность достоверности
недопустимость: недопустимости
избыточных: избыточных
несовместимый: несовместимых
осуществляться: осуществляется
выгодоприобретатель: выгодоприобретателем
получатель: получателем
которому: которому
утрата: утраты утратой
необходимость: необходимости
иное: иное
справедливый: справедливой
возложить: возложенных
работник: работников работники работниках
предоставляемого: предоставляемого
конклюдентных: конклюдентных
политика: политикой политике
неавтоматизированный: неавтоматизированным
отчество: отчество
контактный: контактного
предоставить: предоставленных
причинить: причинить
обязанный: обязан
распространять: распространять
обрабатываемые: обрабатываемые
избыточный: избыточными
организационный: организационные
неправомерный: неправомерных
планироваться: планируются
реализоваться: реализуются
приведённым: приведённым
статьёй: статьёй
перечень: перечень
достаточный: достаточных
частность: частности
внедрить: внедрены
акт: актами
выявление: выявление
применяться: применяются применяется
нормативный: нормативным
проводиться: проводится
причинён: причинён
соотношение: соотношения
ознакомить: ознакомлены
мероприятие: мероприятий
неполный: неполными
устаревший: устаревшими
неточный: неточными
незаконно: незаконно
отозвать: отозвать
обратившись: обратившись
реализация: реализации
случае: случае
иным: иным
свобода: свободы
обжаловать: обжаловать
бездействие: бездействие
актуализируется: актуализируется
уважительный: уважительное
общение: общение
дискуссия: дискуссии
администратор: администраторы
удалять: удаляют
блокировать: блокируют блокировать
систематический: систематические
деструктивно: деструктивно
нецензурно: нецензурно
выражаться: выражаться
провоцировать: провоцировать
призывать: призывать
разжигать: разжигать
вражда: вражду
жестокий: жестокий жестокого
убийство: убийств
запретить: запрещены
употребление: употребление
ссылаться: ссылаться ссылается
онлайнказино: онлайнказино
пиратский: пиратский
закон: законы
вредить: вредить
рекламировать: рекламировать
привлечь: привлечь
инициировать: инициировать
политический: политические
представляться: представляться
аппетайзеры: аппетайзеры
сытный: сытные сытным
аппетитный: аппетитных аппетитную аппетитные аппетитный
аппетайзер: аппетайзер
немыслим: немыслим
аппетайзеров: аппетайзеров
сёмгой: сёмгой
сливочный: сливочного сливочное
шампиньон: шампиньоны
пряный: пряный пряной
икра: икрой икры
тростниковый: тростникового
соль: соль
промойте: промойте
трёхсантиметровыми: трёхсантиметровыми
посыпьте: посыпьте
постоять: постоять
фольгой: фольгой
противень: противень
решётку: решётку
разогрейте: разогрейте
ºс: ºс
кусочек: кусочек
ломтик: ломтик
обваляйте: обваляйте
тростниковом: тростниковом
покрывать: покрывать
выложить: выложите
решётка: решётку
отправьте: отправьте
подача: подачей
посыпать: посыпьте
рубленый: рубленой
петрушка: петрушкой
копчёный: копчёной
сёмга: сёмги
пучок: пучок
сформуйте: сформуйте
холодильнике: холодильнике
вырезать: вырежьте
сёмги: сёмги
кружка: кружки
сантиметр: сантиметров
металлический: металлическими
кондитерский: кондитерские
шар: шар шарам
рыбой: рыбой
ровные: ровные
плёнка: плёнку плёнкой
измельчите: измельчите
сырнорыбные: сырнорыбные
королевский: королевских
твёрдый: твёрдого твёрдыми
столовый: столовые
ложка: ложки
оливковый: оливкового
молотый: молотого
вымойте: вымойте
мелко: мелко
порежьте: порежьте
обжарить: обжарьте
оливковом: оливковом
приобретёт: приобретёт
золотистый: золотистый
шляпка: шляпки
тёртый: тёртым
выпекать: выпекайте
лист: листы листьев листья листьями
ложке: ложке
сахар: сахар
мл: мл
чесночный: чесночного
крупномолотый: крупномолотого крупномолотый
крахмал: крахмал крахмалом
смешайте: смешайте
пропущенный: пропущенный
натереть: натёртую
приправить: приправьте
перемешайте: перемешайте
размороженные: размороженные
квадратный: квадратные
разрезать: разрежьте
диагонали: диагонали
треугольник: треугольник
хвостики: хвостики
разворачиваться: разворачивалось
смазать: смажьте смазать
край: края
смесь: смесь
сотейник: сотейник
огонь: огне
растворится: растворится
измельчённый: измельчённый
остыть: остыть остынет
помидорок: помидорок
моцареллы: моцареллы
бальзамический: бальзамического бальзамический бальзамическим
помешивать: помешивая
томаты: томаты
полейте: полейте
уксус: уксусом
песочный: песочного
измельчить: измельчите
сок: соком
мож: мож
фасолевый: фасолевый
луковый: луковый
норвежский: норвежский
картофель: картофель картофеля
жирность: жирности
залейте: залейте
варить: варить
прозрачность: прозрачности
кастрюля: кастрюлю
пюре: пюре
сухарик: сухариками
репчатый: репчатого
свежемолотый: свежемолотый
тимьян: тимьяна
лавровый: лавровый
яблочный: яблочным яблочного яблочный
деревенский: деревенского деревенское
грюйер: грюйер
нарезанный: нарезанный
сковороде: сковороде
пена: пены
жарьте: жарьте
мягкость: мягкости
убавить: убавьте
минимум: минимума
готовьте: готовьте
помешивая: помешивая
приобрести: приобрести
золотистокоричневый: золотистокоричневый
начнёт: начнёт
пригорать: пригорать
подгореть: подгоревшие
соскребать: соскребать
спирт: спирта
влейте: влейте
прибавить: прибавьте
разлейте: разлейте
горшочек: горшочкам
погрузиться: погрузились
расплавится: расплавится
магрибский: магрибский
мёда: мёда
корица: корицы
кинзы: кинзы
нарубленный: нарубленный
специя: специй специи
пережарить: пережарьте
помидоры: помидоры
избавьтесь: избавьтесь
кожица: кожицы
заправить: заправьте
мёд: мед
кинзу: кинзу
нарубленных: нарубленных
картофелина: картофелины
морковь: морковь
швейцарский: швейцарский
сельдерей: сельдерея сельдерей
разделайте: разделайте
сёмгу: сёмгу
мякоть: мякоть
вынуть: выньте
остывать: остывать
подсоленной: подсоленной
слейте: слейте
сваренный: сваренный
закипание: закипания
выключите: выключите
подаче: подаче
прийтись: придутся
самому: самому
привередливый: привередливому
лосось: лосось
гранатовый: гранатовым гранатового гранатовый
консервированных: консервированных
паста: пасту
нарезанного: нарезанного
каперс: каперсов
свежий: свежего
эстрагон: эстрагон
сушёный: сушёного
сотейнике: сотейнике
золотистой: золотистой
нарезанные: нарезанные
каперсы: каперсы
кипение: кипения
нарезанной: нарезанной
стейк: стейка
лосося: лосося
выстеленный: выстеленный
фольга: фольгу
смажьте: смажьте
разделяться: разделяться
вилка: вилкой
жидкость: жидкость жидкости
полить: полейте
чеддер: чеддер
листик: листиков
половинка: половинкой
столовая: столовой
овощечистка: овощечистку
очищенных: очищенных
овощной: овощного
посыпка: посыпки
выкладывать: выкладывая
крупно: крупно
измельчённые: измельчённые
впитается: впитается
порциями: порциями
половнику: половнику
дожидаться: дожидаясь
впитает: впитает
кремообразную: кремообразную
консистенция: консистенцию
зёрна: зёрна
наступать: наступает
трапеза: трапезы
меренгой: меренгой
павлóва: павлóва
заварной: заварным
диетический: диетический
меренга: меренги
пшеничный: пшеничной пшеничную
порезанного: порезанного
сахарный: сахарной
пудра: пудры пудру пудра пудрой
желток: желток желтка
нерафинированный: нерафинированного
апельсин: апельсин
горка: горки
натёртая: натёртая
комбайн: комбайне
перетереть: перетереть
припылить: припылённой
мука: мукой
переложить: переложите
блестящий: блестящей
насыпать: насыпьте
разогретой: разогретой
подрумяниться: подрумяниться
вынимая: вынимая
запекаться: запекается
постепенно: постепенно
разбавьте: разбавьте
апельсиновый: апельсиновый
увеличиться: увеличился
вылейте: вылейте
кастрюлю: кастрюлю
гладкой: гладкой
вмешайте: вмешайте
растворение: растворения
желтки: желтки
пик: пиков
подсыпать: подсыпьте
отведённого: отведённого
взбивать: взбивать
однородный: однородной однородную
плотной: плотной
подогрейте: подогрейте
меренгу: меренгу
краёв: краёв
соприкасаться: соприкасаться
золотистокоричневой: золотистокоричневой
получаса: получаса
пирога: пирогу пироги
ягода: ягод ягоды
картофельный: картофельного
взятыми: взятыми
щепоткой: щепоткой
понемногу: понемногу
всыпать: всыпать
пика: пики
желаемый: желаемому
выложите: выложите
очерченного: очерченного
середина: середины
твёрдой: твёрдой
остывание: остывания
выпечь: выпечь
вечер: вечером
пышный: пышной
воздушный: воздушной
меренговую: меренговую
ягодами: ягодами
просеянной: просеянной
молоко: молоко
пополам: пополам
толстый: толстым
растает: растает
отставать: отставать
миксер: миксер
выстелить: выстеленный выстелите
пирожное: пирожных
пирожные: пирожные
перелейте: перелейте
выловить: выловите
выскребите: выскребите
обратно: обратно
побелеть: побелеет
медленном: медленном
остужать: остужайте
пирожный: пирожные
поперёк: поперёк
профитроль: профитроль
растопленным: растопленным
зрелый: зрелых
полусухого: полусухого
бадьян: бадьяна
мороженое: мороженое мороженого
засыпать: засыпьте
позже: позже
мороженый: мороженым
винный: винным
отварный: отварного
разрыхлитель: разрыхлителя
раскрошенного: раскрошенного
горький: горького
блендере: блендере
подливать: подливая
остальные: остальные
растительным: растительным
зубочисткой: зубочисткой
подчеркнёт: подчеркнёт
освежать: освежающий
лимонад: лимонад
согревать: согревающая
хурмой: хурмой
сидр: сидром
сироп: сироп
агава: агавы
клюквенный: клюквенная
растворимый: растворимого
увеличить: увеличьте увеличить
раствор: раствор
долейте: долейте
литровый: литровой
стеклянный: стеклянной
ваниль: ваниль
плотно: плотно
прохладный: прохладное
настаиваться: настаивается
мягче: мягче
встряхивать: встряхивать
однородность: однородность
субстанция: субстанции
полугода: полугода
очистить: очищенного
тонко: тонко
палочка: палочек
нарезанная: нарезанная
хурма: хурмы
имбиря: имбиря
слабом: слабом
чашкам: чашкам
гвоздика: гвоздики
кипеть: кипеть
кружочек: кружочками
серебряный: серебряной
текила: текилы
шейкере: шейкере
встряхнуть: встряхните
процеженный: процеженный
клюква: клюквы
яблоко: яблоко
нарезать: нарезанная
апельсина: апельсина
подачей: подачей
срезать: срежьте
соломка: соломкой
бросьте: бросьте
мята: мяты
выдавить: выдавите
холодильника: холодильника
охлаждённый: охлаждённый
чтобы: чтобы
концентрированный: концентрированный
несолёный: несолёной
минеральный: минеральной
газ: газом
просты: просты
грейпфрут: грейпфрута
пропорция: пропорциях
цедра: цедрой
мяты: мяты
веточка: веточкой
чей: чей
хвойный: хвойный
пикантность: пикантности
мяте: мяте
ликёра: ликёра
интересное: интересное
мультиварки: мультиварки
санктпетербург: санктпетербург
сведение: сведений
основной: основные основной
взаимосвязанных: взаимосвязанных
статический: статических
текстовый: текстовые
объединить: объединенных
уполномочить: уполномоченные
владелец: владельцем владельца владельцев
проживание: проживания
местоположении: местоположении
типе: типе
характеристика: характеристиках
тип: типе
реферер: реферер
запрашивать: запрашиваемых
иная: иная
настройкам: настройкам
заголовок: заголовок
расположенный: расположенный
вебсервером: вебсервером
веббраузер: веббраузер
пересылает: пересылает
вебсерверу: вебсерверу
служить: служит
учёт: учета
сетевой: сетевой
дееспособный: дееспособное
достигнуть: достигшее
совершеннолетие: совершеннолетия
полномочный: полномочным
интернетсайта: интернетсайта
одновременный: одновременное
безоговорочный: безоговорочное
несогласие: несогласия
воздержаться: воздержаться
воля: волей
пользователе: пользователе
информационнотелекоммуникационных: информационнотелекоммуникационных
производиться: производится
зарегистрировать: зарегистрированного
smsопросов: smsопросов
клиентский: клиентской клиентские
удовлетворённость: удовлетворенности
установление: установления
устройстве: устройстве
дополнять: дополнять
предоставленную: предоставленную
администрирование: администрирования
яндексметрика: яндексметрика
отказаться: отказаться
сохранение: сохранения
специализированный: специализированным специализированных
данная: данная
личность: личности
сообщать: сообщает
назначаться: назначаются
ответственный: ответственные
обучить: обучены
проинструктировать: проинструктированы
утвердить: утверждены
должностной: должностные
помещение: помещений
обрабатываться: обрабатываются
обеспечиваться: обеспечивается
антивирусный: антивирусного
запирающегося: запирающегося
заключенных: заключенных
условии: условии
применимый: применимым
рамках: рамках
применительно: применительно
письменный: письменной
согласиться: согласился
данную: данную
правоотношение: правоотношений
разглашение: разглашении разглашением
информировать: информировать
предотвращение: предотвращению
своевременный: своевременного
обновленными: обновленными
направляться: направляются
расположены: расположены
иннкпп: иннкпп
внтерг: внтерг
округ: округ
лисичанская: лисичанская
помещ: помещ
купон: купоны
транспортный: транспортное
нуждаться: нуждается нуждаются
постоянном: постоянном
полироли: полироли
фильтры: фильтры
расходный: расходные
автотовары: автотовары
шиномонтаж: шиномонтаж
шина: шины
автоистория: автоистория
автомаг: автомаг
автомое: автомое
авторусь: авторусь
автосеть: автосеть
альбатрос: альбатрос
багажный: багажные
всёсмарт: всёсмарт
гиперавто: гиперавто
движок: движком
домострой: домострой
лукойлшоп: лукойлшоп
масломаркет: масломаркет
мастак: мастак
мегастрой: мегастрой
дворник: дворников
ого: ого
онлайнтрейдру: онлайнтрейдру
пэкмолл: пэкмолл
раён: раён
сибирь: сибирь
студия: студия
техномолл: техномолл
техпром: техпром
эксклюзив: эксклюзив
электросила: электросила
энергобум: энергобум
яндексмаркет: яндексмаркет
гипермаркет: гипермаркеты
кредит: кредиты
профессионально: профессионально
наполнить: наполнить
аудит: аудит
промокодам: промокодам
переплачивать: переплачивать
регистраторы: регистраторы
хостинг: хостинг
айхор: айхор
аспро: аспро
новофон: новофон
спринтхост: спринтхост
турболого: турболого
хабр: хабр
яндексдирект: яндексдирект
превращать: превращают
учебный: учебную учебный
звукозапись: звукозаписи
делимобиль: делимобиль
гонка: гонки
uraмобиль: uraмобиль
альфаинвестиции: альфаинвестиции
альфакапитал: альфакапитал
бери: бери
подземелье: подземелий
легенда: легенд
дракономании: дракономании
лукойл: лукойл
мойкамойка: мойкамойка
нефтьмагистраль: нефтьмагистраль
однажды: однажды
новелла: новеллы
хроника: хроники
вечность: вечности
юла: юла
яндексдрайв: яндексдрайв
яндексзаправки: яндексзаправки
яндекспро: яндекспро
сюжет: сюжеты
основанные: основанные
реалистичные: реалистичные
механик: механика
одиночный: одиночные
многопользовательский: многопользовательские
симулятор: симуляторы
аркада: аркады
жанр: жанрах жанрам
признать: признанных
браузерный: браузерные
аллод: аллоды
престол: престолов
гамазавр: гамазавр
гладиатор: гладиаторы
игромагаз: игромагаз
игрорай: игрорай
ангел: ангелов
малиновка: малиновка
меч: меч
монополия: монополия
сайтостроение: сайтостроение
семьёй: семьёй
запутанный: запутанный
квест: квестов
друг: друзей
побывать: побывать
концерт: концерт концерты
посетить: посетить
выставка: выставку
художник: художников
аудио: аудио
видеосервис: видеосервисы
билет: билеты
интернетаукционы: интернетаукционы
квизы: квизы
кинотеатр: кинотеатры
театры: театры
хобби: хобби
творчество: творчество
центр: центры
экскурсия: экскурсии
28ой: 28ой
звезда: звезд
петля: петель
авиадух: авиадух
айфлай: айфлай
александринский: александринский
аэрофлот: аэрофлот
аэроэкспресс: аэроэкспресс
балтийский: балтийский
умник: умников
беговой: беговых
октябрьский: октябрьский октябрьская
бродвей: бродвей
вернуться: вернувшиеся
весёлый: веселая
сова: сова
водоходъ: водоходъ
волшебный: волшебная
миля: миля
воробьевы: воробьевы
воронежский: воронежский
втк: втк
кондитер: кондитер
выдумщики: выдумщики
высотный: высотный
вязаныйрф: вязаныйрф
горкасса: горкасса
городской: городская
ферма: ферма
экспресс: экспресс
влюбленных: влюбленных
домотехника: домотехника
домпряжирф: домпряжирф
екатеринбургский: екатеринбургский
заяц: зайцы
зарядье: зарядье
игор: игора
игровед: игровед
игроландия: игроландия
игротайм: игротайм
казанский: казанский
марафон: марафон
калининградский: калининградский
касса40: касса40
квестикс: квестикс
кидбург: кидбург
киноквартал: киноквартал
киносити: киносити
клаустрофобия: клаустрофобия
козёл: козлов
комедиант: комедианты комедианта
чайковский: чайковского
кострома: кострома
котоваська: котоваська
крокус: крокус
юлия: юлии
высоцкий: высоцкой
лебяжий: лебяжий
лимпопо: лимпопо
лицедеи: лицедеи
логос: логос
люксор: люксор
майшоп: майшоп
мариинский: мариинский
мгт: мгт
мелодия: мелодия
мешок: мешок
вышивка: вышивки
олимпиада: олимпиад
термы: термы
мираж: мираж
михайловский: михайловский
моибилетырф: моибилетырф
молодёжный: молодежный
фонтанка: фонтанке
монетникру: монетникру
мореон: мореон
мосигра: мосигра
москвасити: москвасити
москвариум: москвариум
москино: москино
мостурфлот: мостурфлот
мосфлот: мосфлот
мтс: мтс
мхат: мхат
холл: холл
литейный: литейном
неоклассик: неоклассика
искусство: искусство
нтвплюс: нтвплюс
сабур: сабуров
ожить: оживший
озорной: озорные
окский: окская
орелконцерт: орелконцерт
останкинский: останкинская
остров: остров
мечта: мечты
передвижник: передвижник
петербургконцерт: петербургконцерт
питерлэнд: питерлэнд
боулинг: боулинг
фейерверк: фейерверк
приют: приют
пряжа: пряжа
рамт: рамт
республика: республика
ривьера: ривьера
робостанция: робостанция
родео: родео
хутор: хутор
рукоделовру: рукоделовру
рэдиссон: рэдиссон
ройал: ройал
самарский: самарский
санктпетербургская: санктпетербургская
связной: связной
трэвел: трэвел
сибкасса: сибкасса
сильвер: сильвер
слетатьру: слетатьру
стс: стс
акимов: акимова
деммени: деммени
маяковского: маяковского
бронной: бронной
образцов: образцова
армия: армии
сатира: сатиры
тереза: терезы
дуровой: дуровой
эстрада: эстрады
текстильторг: текстильторг
теплоход: теплоход
спб: спб
торренттв: торренттв
тортомастер: тортомастер
третьяковский: третьяковская
триколор: триколор
тульский: тульский
туроператор: туроператор
дельфин: дельфин
улетные: улетные
уникс: уникс
уральский: уральские уральский
пельмени: пельмени
феерияру: феерияру
ростов: ростов
хк: хк
металлург: металлург
хлоп: хлоп
шахматы: шахматы
швейный: швейное
королевство: королевство
экспериментаниум: экспериментаниум
элекс: элекс
этномир: этномир
юбилейный: юбилейный
ямоделист: ямоделист
яндексафиша: яндексафиша
яндексмузыка: яндексмузыка
ярмарка: ярмарка
сбалансировать: сбалансированный
ветеринарный: ветеринарные
препарат: препараты
безопасный: безопасны
грызун: грызунов
оптимальный: оптимальной
насекомое: насекомых
рыбка: рыбок
зоооптторг: зоооптторг
кролик: кролик
зоогалерея: зоогалерея
зоомаркет: зоомаркет
зоопассаж: зоопассаж
зоостолица: зоостолица
котматрос: котматрос
лемуррр: лемуррр
любимчик: любимчик
меломан: меломан
хвостатый: хвостатых
гав: гав
мокрый: мокрый
окей: окей
ус: усами
филя: филя
хвоост: хвоост
хвостатыйру: хвостатыйру
хрустик: хрустик
лапа: лапы
сомневаться: сомневаетесь
доверить: доверить
егэ: егэ
составление: составление
спортзале: спортзале
spaсалоны: spaсалоны
грузоперевозка: грузоперевозки
изучение: изучение
интернетпровайдеры: интернетпровайдеры
кешбэк: кешбэк
клуб: клубы
привилегия: привилегий
научноисследовательские: научноисследовательские
планировка: планировка
платёжный: платежные
агрегатор: агрегаторы
лайк: лайков
подписчик: подписчиков подписчики
велосипед: велосипедов
салон: салоны
страхование: страхование
трансфер: трансфер
предприниматель: предпринимателей
фотопечать: фотопечать
альфабанк: альфабанк
альфастрахование: альфастрахование
аюна: аюна
брат: братья
чистовы: чистовы
бруноям: бруноям
всем: всем
возовоз: возовоз
вольница: вольница
вск: вск
гайде: гайде
тройка: тройка
двадцать: двадцать
домовенок: домовенок
другвокруг: другвокруг
дуолинго: дуолинго
егэстудия: егэстудия
инвитро: инвитро
ингосстрах: ингосстрах
инфостарт: инфостарт
инфоурок: инфоурок
инфоурокрепетиторы: инфоурокрепетиторы
лидертаск: лидертаск
логиклайк: логиклайк
мастеркласс: мастеркласс
мерсибо: мерсибо
многору: многору
зубной: зубной
мойсклад: мойсклад
касса: касса
мультифото: мультифото
нии: нии
эврика: эврика
ниидпо: ниидпо
открытие: открытие
перекрёсток: перекресток
впрок: впрок
полис: полис полисов
помогатель: помогатель
поступи: поступи
правоведru: правоведru
промсвязьбанк: промсвязьбанк
профи: профи
райффайзенбанк: райффайзенбанк
ренессанс: ренессанс
ржд: ржд
росбанк: росбанк
росгосстрах: росгосстрах
ростелеком: ростелеком
сбер: сбер
сберздоровье: сберздоровье
сбермобайл: сбермобайл
сберпрайм: сберпрайм
сберстрахование: сберстрахование
связный: связной
сдайнакоронавирусрф: сдайнакоронавирусрф
сдэк: сдэк
синэво: синэво
сксавто: сксавто
скутершерингрф: скутершерингрф
слерм: слерм
совкомбанк: совкомбанк
спросиврача: спросиврача
тайрай: тайрай
твой: твой твоему твоей
учидома: учидома
учиру: учиру
учмет: учмет
фоксфорд: фоксфорд
фотопроект: фотопроект
хохлов: хохлов
сабатовский: сабатовский
церебро: церебро
таргет: таргет
циан: циан
чевостик: чевостик
экстерн: экстерн
юнистрим: юнистрим
яндексаренда: яндексаренда
яндексбизнес: яндексбизнес
яндексдиск: яндексдиск
яндексздоровье: яндексздоровье
яндекславка: яндекславка
яндексоблако: яндексоблако
яндексплюс: яндексплюс
яндексуслуги: яндексуслуги
ясно: ясно
непросто: непросто
дата: даты
забронировать: забронировать
гостиница: гостиницу гостиницы
туристический: туристических
авиабилет: авиабилеты
жильё: жилья
автобус: автобус
путешественник: путешественников
тур: туры
суточнору: суточнору
агентру: агентру
амбассадор: амбассадор
аэротур: аэротур
бархатный: бархатные
сезон: сезонов
богатырь: богатырь
винтерфелл: винтерфелл
имеретинский: имеретинский
космос: космос космоса
круизонлайн: круизонлайн
лесной: лесная лесное
рапсодия: рапсодия
петергоф: петергоф
орловский: орловский
президентотель: президентотель
путевкаком: путевкаком
репинская: репинская
терийоки: терийоки
авиалиния: авиалинии
фореста: фореста
фестиваль: фестиваль
хостел: хостел
царьград: царьград
яхонт: яхонты
ногинск: ногинск
ресторан: ресторанов рестораны
изыскать: изысканное
воскресный: воскресного
бары: бары
пиццерия: пиццерии
сушибары: сушибары
перекусы: перекусы
zебры: zебры
ёбидоёби: ёбидоёби
ёрш: ёрш
абрикос: абрикос
автосуши: автосуши
алло: алло
архыз: архыз
асс: асса
бахетле: бахетле
бахрома: бахрома
бронибой: бронибой
бургер: бургер
верныйдоставка: верныйдоставка
вкусвилл: вкусвилл
вкусдоставка: вкусдоставка
вкусмил: вкусмил
вкусно: вкусно
всёхорошо: всёхорошо
вьеткафе: вьеткафе
гамбринус: гамбринус
гиннотаки: гиннотаки
гриль: гриль
грильница: грильница
хо: хо
малышев: малышевой
дикоед: дикоед
добрынинский: добрынинский
домпиццы: домпиццы
достаевский: достаевский
жизньмарт: жизньмарт
икорный: икорный
пицца: пиццы
калинов: калинов
каратэ: каратэ
суша: суши
каспийка: каспийка
костис: костис
краснодарский: краснодарский
крыло: крыло
кушай: кушай
лечебный: лечебные
шашлык: шашлык
лоло: лоло
макароллыч: макароллыч
марчеллис: марчеллис
машенькины: машенькины
конфитюр: конфитюр
мельница: мельница
мимино: мимино
михайлик: михайлик
моккано: моккано
моремания: моремания
моспицца: моспицца
мясберри: мясберри
мясницкий: мясницкий
мясничий: мясничий
неместный: неместные
ногбон: ногбон
омолоко: омолоко
ох: ох
пиzzбург: пиzzбург
пиргорой: пиргорой
пироговый: пироговый
интемпо: интемпо
перцы: перцы
темпо: темпо
шляпа: шляпа
пиццбург: пиццбург
подкрепицца: подкрепицца
пользадиет: пользадиет
потехин: потехин
почётный: почетный
престо: престо
пронто: пронто
простоквашино: простоквашино
просуши: просуши
пхалихинкали: пхалихинкали
пятёрочка: пятерочка пятерочке
румянец: румянцев
рустерс: рустерс
самурай: самурай
саюри: саюри
северметрополь: северметрополь
сергейс: сергейс
совасова: совасова
супер: супер
супра: супра
бай: бай
бокс: бокса
весла: весла
гурмэ: гурмэ
мах: мах
сушипрофи: сушипрофи
сомелье: сомелье
сыроварня: сыроварня
тандыр: тандыр
теремок: теремок
тосуши: тосуши
тыква: тыква
тюбетей: тюбетей
павлович: палыча
фокс: фокс
хваловские: хваловские
хлебпром: хлебпром
хорошики: хорошики
хоум: хоум
цех: цех
черноголовка: черноголовка
честной: честная
чикен: чикен
шаверно: шаверно
шашлыкоff: шашлыкоff
шашлычный: шашлычный
шёлковый: шелковый
штолле: штолле
экомаркет: экомаркет
экорыба: экорыба
эрни: эрни
ялюблюсуши: ялюблюсуши
примус: примус
яндекседа: яндекседа
япономания: япономания
торжество: торжества
вдвойне: вдвойне
уложиться: уложиться
скромный: скромный
заказывать: заказывайте
продавец: продавцов продавцом
сувенир: сувениры
сертификат: сертификаты
амберхолл: амберхолл
букетымигом: букетымигом
великоросс: великоросс
всемподарок: всемподарок
баллон: баллон
камневеды: камневеды
крастибокс: крастибокс
минерал: минерал
голландия: голландия
простоцветы: простоцветы
союзцветторг: союзцветторг
фанбургру: фанбургру
флористру: флористру
шарикиру: шарикиру
шарик: шариков
эмпрана: эмпрана
производительность: производительность производительности
надёжность: надёжность
бесперебойность: бесперебойность
аудиотехника: аудиотехника аудиотехники
киберспорт: киберспорт
радиоуправляемые: радиоуправляемые
компонент: компоненты
цент: центов
вольт: вольт
айсберг: айсберг
амперка: амперка
стиральный: стиральные стиральных
всекабели: всекабели
встройкасоло: встройкасоло
продам: продам
доминго: доминго
домовой: домовой
техно: техно
маруся: маруся
кейсберри: кейсберри
миркли: миркли
миртн: миртн
насвязи: насвязи
румиком: румиком
самсунг: самсунг
запчасть: запчастей
технолав: технолав
техностудия: техностудия
торгпк: торгпк
цифрус: цифрус
электроград: электроград
благоустройство: благоустройства
затевать: затевать
шторы: шторы
инвентарь: инвентарь инвентаря
заказе: заказе
преображение: преображения
мебель: мебель
комната: комнаты
семя: семян
mrсковородкин: mrсковородкин
агросемфонд: агросемфонд
амперкин: амперкин
барьер: барьер
бассейнру: бассейнру
благодатный: благодатный
всеинструментыру: всеинструментыру
всестульяру: всестульяру
галамарт: галамарт
гейзер: гейзер
грядка: грядки
гуд: гуд
гурман: гурман
домовый: домовой
железнаямебельрф: железнаямебельрф
инсантрикру: инсантрикру
краскиру: краскиру
крепыж: крепыж
лайфмебель: лайфмебель
мерлен: мерлен
люстра: люстра
мустаевой: мустаевой
матрас: матрас матрасов
матраскровать: матраскровать
мебельбор: мебельбор
мебельмаркет: мебельмаркет
мебельоптторг: мебельоптторг
минифермер: минифермер
мосплитка: мосплитка
надоммебель: надоммебель
ножиков: ножиков
огого: огого
океандра: океандра
парфюмлидер: парфюмлидер
мебельный: мебельный
петрович: петрович
полкомода: полкомода
посудабогемия: посудабогемия
пуше: пуше
огород: огород огорода
сад: сады
самбери: самбери
сантехмолл: сантехмолл
почтой: почтой
синэлэлектрика: синэлэлектрика
скандмебель: скандмебель
сом: сом
строительный: строительный
стройландия: стройландия
суперпосуда: суперпосуда
тбммаркет: тбммаркет
технониколь: технониколь
титанстрой: титанстрой
хозмаркетру: хозмаркетру
диван: диванов
энкор: энкор
этм: этм
ходить: ходить
переполненный: переполненным
шерстяной: шерстяной
бельё: белье
носка: носки
карнавальный: карнавальные
костюм: костюмы
шуба: шубы
стокманн: стокманн
бельетаж: бельетаж
блокпост: блокпост
боско: боско
аутлет: аутлет
гум: гум
каляев: каляев
снежный: снежная
стольник: стольник
техноавиа: техноавиа
хасл: хасл
тело: телом
остаётся: остаётся
бьютибоксы: бьютибоксы
витамин: витамины
бады: бады
органический: органическая
ортопедический: ортопедические
линза: линзы
полость: полостью
алоэ: алоэ
аптечный: аптечная
архангельский: архангельские
водоросль: водоросли
горздрав: горздрав
дары: дары
духирф: духирф
ботэ: ботэ
ирригаторру: ирригаторру
крымский: крымская
лизабокс: лизабокс
линзмастер: линзмастер
линзыру: линзыру
линзыпитер: линзыпитер
лэтуаль: лэтуаль
медси: медси
монастырёврф: монастырёврф
опаснаябритварф: опаснаябритварф
кронос: кронос
ортолайн: ортолайн
гош: гош
самсонфарма: самсонфарма
слепой: слепая
созвездие: созвездие
спеллсмелл: спеллсмелл
стоммаркет: стоммаркет
счастливый: счастливый
фармленд: фармленд
хитэк: хитэк
эвалар: эвалар
элизэ: элизэ
сидимдома: сидимдома
дистанционный: дистанционное
вперед: вперед
переобуйся: переобуйся
какимто: какимто
расстраиваться: расстраивайтесь
раздача: раздачей
скидочный: скидочных
промокупон: промокупон
секретный: секретный
акционные: акционные
ограниченный: ограниченное
предусматривать: предусматривает
легальный: легальны
покупатель: покупатель покупателей
раздаваться: раздаются
лояльность: лояльности
процентный: процентном процентную
сумме: сумме
ваучер: ваучер
посещении: посещении
начисляться: начисляется
оплачиваться: оплачивалась
бонусный: бонусный
разновидность: разновидность
nый: nый
практиковаться: практикуется
кофейня: кофейнями
онлайнсервисы: онлайнсервисы
стриминговый: стриминговые
применить: применить
оформлении: оформлении
скопированный: скопированный
уменьшиться: уменьшится
сообщите: сообщите
чате: чате
промокодом: промокодом
нажимать: нажимаю
публикуем: публикуем
берёте: берёте
сотрудничать: сотрудничаем
ассортимент: ассортимент
присылать: присылают
промокодами: промокодами
выбирай: выбирай
исполнитель: исполнителей
театральный: театральные
увлекательный: увлекательные
логика: логики
образный: образного
подробнее: подробнее
ввод: ввода
расположено: расположено
кинопоиску: кинопоиску
красочный: красочный
серый: серый
шестьдесят: шестьдесят
пропусти: пропусти
азазель: азазель
рейтинговый: рейтинговый
йеллоустоун: йеллоустоун
активация: активацией активации
флейта: флейта
гром: гром
премьера: премьеры
печали: печали
чрезвычайный: чрезвычайная
десяток: десятки
топовый: топовых
мажор: мажор
ивлеевой: ивлеевой
прилучным: прилучным
финник: финник
фантастический: фантастический
роковой: роковой
гештальт: гештальт
головокружительный: головокружительный
вышка: вышка
амедиатекой: амедиатекой
сериалы: сериалы
мульти: мульти
правосудие: правосудие
триалподписке: триалподписке
сможешь: сможешь
повар: поваров
активируй: активируй
получай: получай
тридцать: тридцать
чиз: чиз
воронеж: воронеж
суперцены: суперцены
окраина: окраине
последующий: последующие
приложении: приложении
пятерочка: пятерочка
тренажёрный: тренажерный
подтянуть: подтянуть
теннис: тенниса
снаряжение: снаряжения
рыбалка: рыбалки
применяй: применяй
сэкономь: сэкономь
снегоход: снегоход снегоходов
сноуборды: сноуборды
мотобуксировщиков: мотобуксировщиков
дорожка: дорожек
фирма: фирмы
электросамокатов: электросамокатов
мотор: моторов
лодка: лодок
спасательный: спасательных
лодкамотор: лодкамотор
абонемент: абонемент абонемента
supборды: supборды
энергетик: энергетик энергетика
тренировочный: тренировочных
рогалик: рогаликов
пепперони: пепперони
цыплёнок: цыпленок
нижний: нижний
новгород: новгород
заказы: заказы
вынос: вынос
яндекседе: яндекседе
минибургеры: минибургеры
лососем: лососем
трюфельный: трюфельным
заказывай: заказывай
внимательно: внимательно
изучи: изучи
специально: специально
популярность: популярностью
приз: призы
достигай: достигай
внутриигрового: внутриигрового
находись: находись
доставка: доставкой
рубеж: рубежа
тщательный: тщательный
гарантированно: гарантированно
дополнительно: дополнительно
индивидуальный: индивидуальный
пробный: пробный
ноль: ноль
летний: летний
обучать: обучающий обучающих
лагерь: лагерь
школьник: школьников
курсы: курсы
вебинары: вебинары
сперва: сперва
зарегистрируйся: зарегистрируйся
налоговый: налоговый налогового
вычет: вычет
занятие: занятие
репетитор: репетитором
урок: уроков
онлайншколы: онлайншколы
упускай: упускай
пройди: пройди
переподготовка: переподготовки
подключение: подключении
бизнестехнологий: бизнестехнологий
спеши: спеши
онлайнкурсы: онлайнкурсы
огэ: огэ
тариф: тарифы
пополняй: пополняй
вознагражение: вознагражение
посылка: посылок
выкуп: выкуп
совершай: совершай
страховка: страховка
страховой: страховых
взр: взр
тарифный: тарифный
упусти: упусти
долгожданный: долгожданные
геймер: геймеров
успей: успей
пополнение: пополнению
выиграй: выиграй
скины: скины
розыгрыш: розыгрыше
кс: кс
го: го
полигон: полигон
пополнении: пополнении
голды: голды
награда: награды
наборы: наборы
специализироваться: специализируется
используй: используй
втором: втором
пылесос: пылесосов
термокружек: термокружек
кешбэком: кешбэком
возврат: возврат
годовой: годовая
телевизор: телевизоров
пыль: пыли
пылесосы: пылесосы
смартпульты: смартпульты
вступлении: вступлении
ультрабуки: ультрабуки
мышь: мышь
кофеварка: кофеварок
экономь: экономь
чехол: чехол
сдаче: сдаче
дам: дам
антивирус: антивирусы
кресло: кресла
гарнитура: гарнитуры
компимент: компимент
килограмм: килограмм
магнитогорск: магнитогорск
пермь: пермь
аяши: аяши
челябинск: челябинск
калифорнию: калифорнию
микрозаймы: микрозаймы
оформляться: оформляются
волокиты: волокиты
выполняться: выполняются
квалифицированный: квалифицированными
оставь: оставь
процент: процентом процентов
кнопкой: кнопкой
выиграть: выиграть
беспроцентный: беспроцентной
ставка: ставкой
миг: миг
одобрить: одобренной
потрать: потрать
кешбэка: кешбэка
продукция: продукция
символика: символикой
яндексмаркете: яндексмаркете
заканчивать: заканчивая
ландыши: ландыши
гостиный: гостиной
роботыпылесосы: роботыпылесосы
приобретение: приобретении
брендовый: брендовая
вступи: вступи
смеситель: смесителей
понравившиеся: понравившиеся
